0,177.8,173,12795,0,173
1,181.2,176,12795,3,173
2,184.2,279,95,6,273
3,186.2,181,12795,9,172
4,187.9,184,12796,12,172
5,190.0,187,12797,15,172
6,191.8,190,12798,18,172
7,194.4,193,12799,21,172
8,196.5,196,0,25,171
9,198.1,199,1,28,171
10,199.9,202,2,31,171
11,201.7,205,3,34,171
12,200.84615384615384,208,7,37,171
13,208.1,211,3,40,171
14,212.3,213,1,43,170
15,217.1,216,12799,46,170
16,221.2,219,12798,50,169
17,223.1,222,12799,53,169
18,225.1,225,0,56,169
19,227.0,228,1,59,169
20,231.0,230,12799,62,168
21,234.9,233,12798,65,168
22,237.3,236,12799,68,168
23,239.5,239,0,71,168
24,242.1,242,0,75,167
25,244.6,245,0,78,167
26,246.4,248,2,81,167
27,248.2,251,3,84,167
28,250.4,253,3,87,166
29,252.8,256,3,90,166
30,255.0,259,4,93,166
31,256.7,262,5,96,166
32,258.9,265,6,100,165
33,261.3,268,7,103,165
34,263.9,271,7,106,165
35,265.8181818181818,273,7,109,164
36,269.8,276,6,112,164
37,274.1,279,5,115,164
38,273.9166666666667,282,8,118,164
39,280.8,284,3,121,163
40,282.9,287,4,125,162
41,284.7,290,5,128,162
42,287.2,293,6,131,162
43,293.4,295,2,134,161
44,299.6,298,12798,137,161
45,302.0,301,12799,140,161
46,304.4,304,0,143,161
47,307.7,307,12799,146,161
48,311.3,309,12798,150,159
49,313.9,312,12798,153,159
50,316.4,315,12799,156,159
51,318.7,318,12799,159,159
52,321.8,321,12799,162,159
53,324.6,324,12799,165,159
54,326.8,326,12799,168,158
55,329.0,329,0,171,158
56,331.3,332,1,175,157
57,334.8,335,0,178,157
58,338.6,338,12799,181,157
59,342.2,341,12799,184,157
60,338.2,343,5,187,156
61,350.27272727272725,346,12796,190,156
62,355.1,349,12794,193,156
63,357.2,352,12795,196,156
64,359.3,353,12794,200,153
65,361.7,356,12794,203,153
66,366.2,359,12793,206,153
67,370.7,361,12790,209,152
68,373.3,364,12791,212,152
69,375.4,367,12792,215,152
70,378.2,370,12792,218,152
71,381.3,372,12791,221,151
72,383.5,375,12792,225,150
73,385.5,378,12792,228,150
74,387.6,381,12793,231,150
75,389.6,384,12794,234,150
76,391.3,387,12796,237,150
77,393.1,389,12796,240,149
78,395.5,392,12796,243,149
79,397.7,395,12797,246,149
80,399.9,398,12798,250,148
81,402.4,401,12799,253,148
82,405.1,404,12799,256,148
83,406.90909090909093,406,12799,259,147
84,410.6363636363636,409,12798,262,147
85,415.0,412,12797,265,147
86,416.8,415,12798,268,147
87,418.7,418,12799,271,147
88,437.6363636363636,421,12783,275,146
89,429.1,424,12795,278,146
90,431.9,426,12794,281,145
91,433.5,429,12796,284,145
92,437.4166666666667,432,12795,287,145
93,438.7,435,12796,290,145
94,441.4,438,12797,293,145
95,443.5,441,12798,296,145
96,445.6,444,12798,300,144
97,447.3,447,0,303,144
98,449.2,450,1,306,144
99,451.5,453,2,309,144
100,453.2,456,3,312,144
101,455.3,459,4,315,144
102,457.4,462,5,318,144
103,460.2,464,4,321,143
104,463.3,467,4,325,142
105,463.6666666666667,470,6,328,142
106,469.6363636363636,473,3,331,142
107,476.6,476,12799,334,142
108,478.8,479,0,337,142
109,480.9,482,1,340,142
110,482.5,485,2,343,142
111,486.6,487,0,346,141
112,490.6,490,12799,350,140
113,492.8,493,0,353,140
114,494.8,496,1,356,140
115,497.5,499,2,359,140
116,500.5,502,2,362,140
117,502.7,505,2,365,140
118,504.2,507,3,368,139
119,506.1,510,4,371,139
120,508.4,513,5,375,138
121,510.9,516,5,378,138
122,513.2,519,6,381,138
123,515.1,522,7,384,138
124,517.3,525,8,387,138
125,520.0,528,8,390,138
126,520.0833333333334,530,10,393,137
127,526.8,533,6,396,137
128,531.6,536,4,400,136
129,534.9,539,4,403,136
130,537.0,542,5,406,136
131,539.3,544,5,409,135
132,541.1,547,6,412,135
133,543.5,550,6,415,135
134,549.5,553,4,418,135
135,555.6,556,0,421,135
136,558.4,558,0,425,133
137,564.2727272727273,561,12797,428,133
138,565.7,564,12798,431,133
139,568.2,567,12799,434,133
140,570.8,570,12799,437,133
141,573.4,573,0,440,133
142,576.7,575,12798,443,132
143,579.6,578,12798,446,132
144,582.0,581,12799,450,131
145,584.3,584,0,453,131
146,586.5,587,0,456,131
147,589.2,590,1,459,131
148,592.8,593,0,462,131
149,597.7,595,12797,465,130
150,595.2142857142857,598,3,468,130
151,609.0,601,12792,471,130
152,611.2,604,12793,475,129
153,613.4,607,12794,478,129
154,615.5,610,12794,481,129
155,617.5,612,12794,484,128
156,621.6,615,12793,487,128
157,627.0,618,12791,490,128
158,630.0,621,12791,493,128
159,634.5833333333334,624,12789,496,128
160,635.5,627,12792,500,127
161,637.8,630,12792,503,127
162,640.0,633,12793,506,127
163,642.4,635,12793,509,126
164,644.7,638,12793,512,126
165,646.9,641,12794,515,126
166,648.6,644,12795,518,126
167,650.4,647,12797,521,126
168,652.5,650,12798,525,125
169,654.6,653,12798,528,125
170,654.75,656,1,531,125
171,661.0,659,12798,534,125
172,663.3636363636364,662,12799,537,125
173,668.4,665,12797,540,125
174,670.5,668,12798,543,125
175,672.4,671,12799,546,125
176,674.1,674,0,550,124
177,676.2,677,1,553,124
178,682.2,680,12798,556,124
179,687.9,683,12795,559,124
180,690.1,686,12796,562,124
181,692.9,689,12796,565,124
182,695.5,692,12796,568,124
183,697.5,695,12798,571,124
184,699.9,698,12798,575,123
185,702.3,701,12799,578,123
186,704.3,704,0,581,123
187,706.0,707,1,584,123
188,708.4,710,2,587,123
189,710.3,713,3,590,123
190,712.0,716,4,593,123
191,715.0,719,4,596,123
192,718.5,722,4,600,122
193,719.4166666666666,725,6,603,122
194,724.5,728,4,606,122
195,732.3,731,12799,609,122
196,734.3,734,0,612,122
197,736.1,737,1,615,122
198,738.1,740,2,618,122
199,744.7272727272727,743,12798,621,122
200,746.6,746,12799,625,121
201,749.2,749,0,628,121
202,751.0,752,1,631,121
203,753.6,755,1,634,121
204,756.2,758,2,637,121
205,758.5,761,2,640,121
206,760.5,764,4,643,121
207,762.9,767,4,646,121
208,765.3,770,5,650,120
209,767.5,773,6,653,120
210,769.5,776,6,656,120
211,771.6,779,7,659,120
212,774.8,782,7,662,120
213,778.2,785,7,665,120
214,781.8,788,6,668,120
215,782.9166666666666,791,8,671,120
216,790.1,794,4,675,119
217,792.4,797,5,678,119
218,794.5,800,6,681,119
219,796.5,803,6,684,119
220,799.6,806,6,687,119
221,805.9,809,3,690,119
222,811.9,812,0,693,119
223,814.6,815,0,696,119
224,817.3,818,1,700,118
225,821.0,821,0,703,118
226,824.8,824,12799,706,118
227,827.7,827,12799,709,118
228,830.8,829,12798,712,117
229,833.5,832,12798,715,117
230,835.9,835,12799,718,117
231,838.5,838,0,721,117
232,841.1,841,0,725,116
233,844.2,844,0,728,116
234,845.2727272727273,847,2,731,116
235,852.8,850,12797,734,116
236,858.7,853,12794,737,116
237,859.25,856,12797,740,116
238,866.4,859,12793,743,116
239,868.8,862,12793,746,116
240,870.9,865,12794,750,115
241,873.6,868,12794,753,115
242,878.1,871,12793,756,115
243,882.9,874,12791,759,115
244,885.7,877,12791,762,115
245,888.2,880,12792,765,115
246,891.2,884,12793,768,116
247,894.2,887,12793,771,116
248,896.8,890,12793,775,115
249,899.2,893,12794,778,115
250,901.0,896,12795,781,115
251,903.2,899,12796,784,115
252,905.0,902,12797,787,115
253,906.9,905,12798,790,115
254,907.4444444444445,908,1,793,115
255,911.3,911,0,796,115
256,912.25,914,2,800,114
257,919.8,918,12798,803,115
258,923.8,921,12797,806,115
259,925.9,924,12798,809,115
260,927.8,927,12799,812,115
261,929.8,930,0,815,115
262,931.9,933,1,818,115
263,937.7,936,12798,821,115
264,944.0,940,12796,825,115
265,946.1,943,12797,828,115
266,951.0,946,12795,831,115
267,951.8,949,12797,834,115
268,953.8,952,12798,837,115
269,956.2,955,12799,840,115
270,958.6,958,12799,843,115
271,960.8,962,1,846,116
272,963.1,965,2,850,115
273,965.4,968,3,853,115
274,967.3,971,4,856,115
275,969.2,974,5,859,115
276,973.0,977,4,862,115
277,974.25,981,7,865,116
278,981.0833333333334,984,3,868,116
279,988.1,987,12799,871,116
280,990.3,990,0,875,115
281,992.2,993,1,878,115
282,994.0,997,3,881,116
283,1002.3846153846154,1000,12798,884,116
284,1001.8,1003,1,887,116
285,1005.5,1006,0,890,116
286,1007.9,1009,1,893,116
287,1010.6,1012,1,896,116
288,1013.1,1016,3,900,116
289,1015.4,1019,4,903,116
290,1017.7,1022,4,906,116
291,1020.1,1025,5,909,116
292,1022.4,1028,6,912,116
293,1024.8,1031,6,915,116
294,1027.0,1034,7,918,116
295,1029.5,1038,8,921,117
296,1032.9,1041,8,925,116
297,1036.9,1044,7,928,116
298,1041.9,1047,5,931,116
299,1046.1,1050,4,934,116
300,1048.7,1054,5,937,117
301,1050.9,1057,6,940,117
302,1053.1,1060,7,943,117
303,1055.6,1063,7,946,117
304,1061.9,1066,4,950,116
305,1069.1,1069,0,953,116
306,1072.5,1072,0,956,116
307,1075.9,1075,12799,959,116
308,1079.6,1079,12799,962,117
309,1082.3,1082,0,965,117
310,1085.3,1085,0,968,117
311,1088.1,1088,0,971,117
312,1091.5,1091,0,975,116
313,1094.5,1094,0,978,116
314,1097.1,1097,0,981,116
315,1099.8,1100,0,984,116
316,1103.3,1103,0,987,116
317,1105.1666666666667,1107,2,990,117
318,1115.2,1110,12795,993,117
319,1120.7,1113,12792,996,117
320,1123.7,1116,12792,1000,116
321,1126.0,1119,12793,1003,116
322,1128.1,1123,12795,1006,117
323,1130.4,1126,12796,1009,117
324,1135.2,1129,12794,1012,117
325,1140.8,1132,12791,1015,117
326,1143.8,1136,12792,1018,118
327,1146.8,1139,12792,1021,118
328,1150.0,1142,12792,1025,117
329,1152.1,1145,12793,1028,117
330,1154.5,1149,12794,1031,118
331,1157.1,1152,12795,1034,118
332,1159.5,1155,12796,1037,118
333,1161.4,1158,12797,1040,118
334,1163.4,1162,12799,1043,119
335,1165.9,1165,12799,1046,119
336,1168.8,1168,12799,1050,118
337,1172.4,1171,12799,1053,118
338,1170.7857142857142,1175,4,1056,119
339,1180.3,1178,12798,1059,119
340,1182.4,1182,0,1062,120
341,1184.7,1185,0,1065,120
342,1187.0,1188,1,1068,120
343,1195.6363636363637,1192,12796,1071,121
344,1198.5,1195,12796,1075,120
345,1201.2,1198,12797,1078,120
346,1203.4,1202,12799,1081,121
347,1206.7,1205,12798,1084,121
348,1210.1,1208,12798,1087,121
349,1212.5,1211,12798,1090,121
350,1214.8,1215,0,1093,122
351,1216.9,1218,1,1096,122
352,1219.3,1221,2,1100,121
353,1221.7,1225,3,1103,122
354,1224.2,1228,4,1106,122
355,1226.7,1231,4,1109,122
356,1231.4,1235,4,1112,123
357,1238.1,1238,0,1115,123
358,1242.8,1241,12798,1118,123
359,1245.1,1245,0,1121,124
360,1247.3,1248,1,1125,123
361,1249.9,1252,2,1128,124
362,1256.3333333333333,1255,12799,1131,124
363,1257.5,1258,0,1134,124
364,1261.1,1262,1,1137,125
365,1263.5,1265,2,1140,125
366,1266.4,1268,2,1143,125
367,1269.5,1272,2,1146,126
368,1272.0,1275,3,1150,125
369,1274.4,1278,4,1153,125
370,1276.7,1282,5,1156,126
371,1279.2,1285,6,1159,126
372,1281.6,1288,6,1162,126
373,1284.2,1292,8,1165,127
374,1287.6,1295,7,1168,127
375,1290.8181818181818,1298,7,1171,127
376,1297.2,1302,5,1175,127
377,1301.7,1305,3,1178,127
378,1304.0,1308,4,1181,127
379,1306.4,1312,6,1184,128
380,1308.7,1315,6,1187,128
381,1311.4,1318,7,1190,128
382,1317.6,1322,4,1193,129
383,1324.9,1325,0,1196,129
384,1328.1,1328,0,1200,128
385,1331.9,1332,0,1203,129
386,1335.8,1335,12799,1206,129
387,1338.8,1338,12799,1209,129
388,1342.0,1341,12799,1212,129
389,1345.6,1345,12799,1215,130
390,1348.6,1348,12799,1218,130
391,1351.4,1351,0,1221,130
392,1354.0,1354,0,1225,129
393,1357.0,1358,1,1228,130
394,1361.4,1361,0,1231,130
395,1364.8333333333333,1365,0,1234,131
396,1376.1,1368,12792,1237,131
397,1378.9,1371,12792,1240,131
398,1381.2,1375,12794,1243,132
399,1383.5,1378,12794,1246,132
400,1386.1,1381,12795,1250,131
401,1390.9,1385,12794,1253,132
402,1396.2,1388,12792,1256,132
403,1399.4,1392,12793,1259,133
404,1402.7,1395,12792,1262,133
405,1406.0,1398,12792,1265,133
406,1408.6,1402,12793,1268,134
407,1411.1,1405,12794,1271,134
408,1413.5,1409,12796,1275,134
409,1415.6,1412,12796,1278,134
410,1418.1,1416,12798,1281,135
411,1420.6,1419,12798,1284,135
412,1423.1,1422,12799,1287,135
413,1426.3,1426,0,1290,136
414,1429.7272727272727,1429,12799,1293,136
415,1435.9,1433,12797,1296,137
416,1438.5,1436,12798,1300,136
417,1440.5,1440,0,1303,137
418,1442.3,1443,1,1306,137
419,1462.24,1447,12785,1309,138
420,1454.0,1450,12796,1312,138
421,1457.2,1454,12797,1315,139
422,1461.2727272727273,1457,12796,1318,139
423,1463.6,1461,12797,1321,140
424,1466.2,1464,12798,1325,139
425,1468.7,1467,12798,1328,139
426,1471.3,1471,0,1331,140
427,1473.6,1474,0,1334,140
428,1476.2,1478,2,1337,141
429,1478.4,1481,3,1340,141
430,1480.6,1485,4,1343,142
431,1484.2,1488,4,1346,142
432,1490.3,1492,2,1350,142
433,1495.0,1495,0,1353,142
434,1500.2,1499,12799,1356,143
435,1502.4,1502,0,1359,143
436,1504.5,1506,2,1362,144
437,1506.6,1509,2,1365,144
438,1510.9,1512,1,1368,144
439,1515.5,1516,0,1371,145
440,1520.3636363636363,1519,12799,1375,144
441,1522.5,1523,0,1378,145
442,1524.9,1526,1,1381,145
443,1527.5,1530,2,1384,146
444,1529.6,1533,3,1387,146
445,1531.9,1537,5,1390,147
446,1535.1,1540,5,1393,147
447,1537.8,1544,6,1396,148
448,1540.4,1547,7,1400,147
449,1543.6,1551,7,1403,148
450,1547.5,1554,6,1406,148
451,1549.4166666666667,1558,9,1409,149
452,1557.7,1561,3,1412,149
453,1560.7,1565,4,1415,150
454,1563.3,1568,5,1418,150
455,1565.7,1571,5,1421,150
456,1580.4,1575,12795,1425,150
457,1576.3,1578,2,1428,150
458,1582.2,1582,0,1431,151
459,1586.1,1585,12799,1434,151
460,1590.4,1589,12799,1437,152
461,1594.0,1592,12798,1440,152
462,1597.4,1595,12798,1443,152
463,1600.5,1599,12798,1446,153
464,1603.3,1602,12799,1450,152
465,1606.7,1605,12798,1453,152
466,1609.6,1609,12799,1456,153
467,1613.0,1612,12799,1459,153
468,1617.2,1616,12799,1462,154
469,1624.1,1619,12795,1465,154
470,1628.6363636363637,1623,12794,1468,155
471,1634.3,1626,12792,1471,155
472,1636.7,1630,12793,1475,155
473,1639.3,1633,12794,1478,155
474,1641.9,1637,12795,1481,156
475,1647.1,1640,12793,1484,156
476,1652.4,1643,12791,1487,156
477,1656.2,1647,12791,1490,157
478,1659.6,1650,12790,1493,157
479,1662.0,1654,12792,1496,158
480,1665.0,1657,12792,1500,157
481,1667.9,1661,12793,1503,158
482,1670.4,1664,12794,1506,158
483,1672.4,1668,12796,1509,159
484,1674.6,1671,12796,1512,159
485,1677.2,1675,12798,1515,160
486,1679.6,1678,12798,1518,160
487,1683.9,1682,12798,1521,161
488,1685.5833333333333,1686,0,1525,161
489,1693.1,1689,12796,1528,161
490,1695.5,1693,12798,1531,162
491,1697.4,1696,12799,1534,162
492,1699.6,1700,0,1537,163
493,1705.7,1703,12797,1540,163
494,1711.9,1707,12795,1543,164
495,1715.6,1710,12794,1546,164
496,1719.0,1714,12795,1550,164
497,1721.5,1717,12796,1553,164
498,1723.7,1721,12797,1556,165
499,1726.2,1724,12798,1559,165
500,1728.5,1728,0,1562,166
501,1730.8,1731,0,1565,166
502,1733.3,1735,2,1568,167
503,1736.0,1738,2,1571,167
504,1738.7,1742,3,1575,167
505,1742.1,1745,3,1578,167
506,1745.6666666666667,1749,3,1581,168
507,1755.0,1753,12798,1584,169
508,1757.6,1756,12798,1587,169
509,1760.5,1760,0,1590,170
510,1762.9,1763,0,1593,170
511,1767.0,1767,0,1596,171
512,1771.8,1770,12798,1600,170
513,1774.8,1774,12799,1603,171
514,1777.8,1777,12799,1606,171
515,1780.6,1781,0,1609,172
516,1783.1,1784,1,1612,172
517,1785.8,1788,2,1615,173
518,1788.2,1791,3,1618,173
519,1790.6,1795,4,1621,174
520,1793.4,1798,5,1625,173
521,1795.9,1802,6,1628,174
522,1798.6,1805,6,1631,174
523,1802.4,1809,7,1634,175
524,1808.3,1812,4,1637,175
525,1807.0,1816,9,1640,176
526,1816.6,1819,2,1643,176
527,1819.0,1823,4,1646,177
528,1821.3,1826,5,1650,176
529,1841.5263157894738,1830,12788,1653,177
530,1833.6,1833,12799,1656,177
531,1839.0,1837,12798,1659,178
532,1843.5,1840,12796,1662,178
533,1846.2,1843,12797,1665,178
534,1849.2,1847,12798,1668,179
535,1852.2,1850,12798,1671,179
536,1855.9,1854,12798,1675,179
537,1859.5,1857,12798,1678,179
538,1862.9,1860,12797,1681,179
539,1865.8,1864,12798,1684,180
540,1868.5,1867,12798,1687,180
541,1871.4,1871,0,1690,181
542,1876.0,1874,12798,1693,181
543,1878.3333333333333,1878,0,1696,182
544,1889.7,1881,12791,1700,181
545,1892.6,1885,12792,1703,182
546,1895.4,1888,12793,1706,182
547,1907.0,1892,12785,1709,183
548,1904.3,1895,12791,1712,183
549,1908.6,1899,12790,1715,184
550,1912.0,1902,12790,1718,184
551,1915.2,1906,12791,1721,185
552,1918.0,1909,12791,1725,184
553,1920.8,1913,12792,1728,185
554,1923.3,1916,12793,1731,185
555,1925.7,1919,12793,1734,185
556,1927.8,1923,12795,1737,186
557,1930.3,1926,12796,1740,186
558,1933.1,1930,12797,1743,187
559,1935.7,1934,12798,1746,188
560,1938.9,1937,12798,1750,187
561,1943.7,1941,12797,1753,188
562,1948.2,1944,12796,1756,188
563,1950.7,1948,12797,1759,189
564,1953.0,1951,12798,1762,189
565,1965.2666666666667,1955,12790,1765,190
566,1963.1,1958,12795,1768,190
567,1969.4,1962,12793,1771,191
568,1972.6,1965,12792,1775,190
569,1974.7,1969,12794,1778,191
570,1976.8,1972,12795,1781,191
571,1979.1,1976,12797,1784,192
572,1981.7,1979,12797,1787,192
573,1984.4,1983,12799,1790,193
574,1987.0,1986,12799,1793,193
575,1989.4,1990,1,1796,194
576,1991.6,1993,1,1800,193
577,1993.8,1996,2,1803,193
578,1996.3,2000,4,1806,194
579,2000.3636363636363,2003,3,1809,194
580,2002.7692307692307,2007,4,1812,195
581,2012.7,2011,12798,1815,196
582,2015.2,2014,12799,1818,196
583,2018.1,2018,0,1821,197
584,2022.6,2021,12798,1825,196
585,2027.6,2024,12796,1828,196
586,2030.6,2028,12797,1831,197
587,2033.4,2031,12798,1834,197
588,2035.7,2035,12799,1837,198
589,2038.5,2038,0,1840,198
590,2040.9,2042,1,1843,199
591,2043.4,2045,2,1846,199
592,2046.1,2049,3,1850,199
593,2048.5,2052,4,1853,199
594,2051.0,2056,5,1856,200
595,2054.0,2059,5,1859,200
596,2057.4,2062,5,1862,200
597,2060.6,2066,5,1865,201
598,2065.1,2069,4,1868,201
599,2064.9166666666665,2073,8,1871,202
600,2073.4,2076,3,1875,201
601,2075.8,2080,4,1878,202
602,2093.6,2083,12789,1881,202
603,2093.8333333333335,2086,12792,1884,202
604,2094.4,2090,12796,1887,203
605,2097.4,2093,12796,1890,203
606,2100.5,2097,12796,1893,204
607,2103.5,2100,12796,1896,204
608,2106.8,2103,12796,1900,203
609,2110.2,2107,12797,1903,204
610,2113.7,2110,12796,1906,204
611,2116.7,2113,12796,1909,204
612,2119.4,2117,12798,1912,205
613,2122.5,2120,12798,1915,205
614,2125.3,2123,12798,1918,205
615,2128.2,2127,12799,1921,206
616,2132.3,2130,12798,1925,205
617,2138.9,2133,12794,1928,205
618,2135.5714285714284,2137,1,1931,206
619,2148.6,2140,12791,1934,206
620,2151.5,2143,12792,1937,206
621,2156.3,2147,12791,1940,207
622,2161.8,2150,12788,1943,207
623,2165.4,2154,12789,1946,208
624,2168.2,2157,12789,1950,207
625,2170.7,2160,12789,1953,207
626,2173.2,2164,12791,1956,208
627,2175.7,2167,12791,1959,208
628,2178.1,2171,12793,1962,209
629,2181.0,2174,12793,1965,209
630,2183.6,2177,12793,1968,209
631,2186.0,2181,12795,1971,210
632,2188.4,2184,12796,1975,209
633,2190.7,2187,12796,1978,209
634,2192.7,2191,12798,1981,210
635,2196.0,2194,12798,1984,210
636,2200.5,2198,12798,1987,211
637,2205.0,2201,12796,1990,211
638,2208.2,2204,12796,1993,211
639,2213.181818181818,2208,12795,1996,212
640,2217.3,2211,12794,2000,211
641,2223.9,2215,12791,2003,212
642,2227.0,2218,12791,2006,212
643,2229.2,2222,12793,2009,213
644,2231.4,2225,12794,2012,213
645,2233.6,2228,12794,2015,213
646,2235.6,2232,12796,2018,214
647,2237.8,2235,12797,2021,214
648,2240.6,2239,12798,2025,214
649,2243.4,2242,12799,2028,214
650,2245.6,2245,12799,2031,214
651,2247.9,2249,1,2034,215
652,2249.9,2252,2,2037,215
653,2252.0,2255,3,2040,215
654,2254.8,2259,4,2043,216
655,2258.9,2262,3,2046,216
656,2265.6,2265,12799,2050,215
657,2271.2,2269,12798,2053,216
658,2277.818181818182,2272,12794,2056,216
659,2280.7,2276,12795,2059,217
660,2284.4,2279,12795,2062,217
661,2286.5,2282,12796,2065,217
662,2288.6,2286,12797,2068,218
663,2290.7,2289,12798,2071,218
664,2292.8,2293,0,2075,218
665,2295.3,2296,1,2078,218
666,2298.5,2299,0,2081,218
667,2301.2,2302,1,2084,218
668,2303.5,2306,2,2087,219
669,2305.9,2309,3,2090,219
670,2308.7,2312,3,2093,219
671,2311.3,2315,4,2096,219
672,2314.0,2319,5,2100,219
673,2317.1,2322,5,2103,219
674,2318.0,2325,7,2106,219
675,2320.5833333333335,2328,7,2109,219
676,2329.7,2332,2,2112,220
677,2332.5,2335,2,2115,220
678,2339.3,2338,12799,2118,220
679,2347.3,2342,12795,2121,221
680,2351.1,2345,12794,2125,220
681,2353.6,2348,12794,2128,220
682,2356.1,2352,12796,2131,221
683,2358.5,2355,12796,2134,221
684,2361.2,2358,12797,2137,221
685,2364.6,2361,12796,2140,221
686,2368.1,2364,12796,2143,221
687,2371.5,2368,12796,2146,222
688,2374.6,2371,12796,2150,221
689,2377.4,2374,12797,2153,221
690,2380.2,2377,12797,2156,221
691,2382.6,2380,12797,2159,221
692,2385.0,2383,12798,2162,221
693,2388.6,2386,12797,2165,221
694,2392.3,2390,12798,2168,222
695,2396.3636363636365,2393,12797,2171,222
696,2404.6,2396,12791,2175,221
697,2412.181818181818,2399,12787,2178,221
698,2415.1,2403,12788,2181,222
699,2419.1,2406,12787,2184,222
700,2421.5,2409,12788,2187,222
701,2423.7,2412,12788,2190,222
702,2426.2,2416,12790,2193,223
703,2428.7,2419,12790,2196,223
704,2430.8,2422,12791,2200,222
705,2433.0,2425,12792,2203,222
706,2435.6,2429,12793,2206,223
707,2438.5,2432,12794,2209,223
708,2441.1,2435,12794,2212,223
709,2443.5,2438,12794,2215,223
710,2445.4,2441,12796,2218,223
711,2447.3,2444,12797,2221,223
712,2449.4,2448,12799,2225,223
713,2452.1,2451,12799,2228,223
714,2455.3,2454,12799,2231,223
715,2456.0,2457,1,2234,223
716,2459.5833333333335,2461,1,2237,224
717,2472.0,2464,12792,2240,224
718,2478.9,2467,12788,2243,224
719,2481.5,2471,12790,2246,225
720,2483.7,2474,12790,2250,224
721,2486.0,2477,12791,2253,224
722,2487.9,2480,12792,2256,224
723,2489.7,2484,12794,2259,225
724,2491.3,2487,12796,2262,225
725,2493.4,2490,12797,2265,225
726,2495.9,2493,12797,2268,225
727,2498.4,2496,12798,2271,225
728,2501.0,2500,12799,2275,225
729,2502.9,2503,0,2278,225
730,2504.7,2506,1,2281,225
731,2506.4,2509,3,2284,225
732,2508.3,2512,4,2287,225
733,2510.4,2515,5,2290,225
734,2513.9,2519,5,2293,226
735,2519.3,2522,3,2296,226
736,2525.176470588235,2525,0,2300,225
737,2534.2,2528,12794,2303,225
738,2538.2,2532,12794,2306,226
739,2540.4,2535,12795,2309,226
740,2542.6,2538,12795,2312,226
741,2544.8,2541,12796,2315,226
742,2546.9,2545,12798,2318,227
743,2548.8,2548,12799,2321,227
744,2550.9,2551,0,2325,226
745,2553.6,2554,0,2328,226
746,2556.3,2557,1,2331,226
747,2558.8,2560,1,2334,226
748,2561.2,2563,2,2337,226
749,2563.6,2566,2,2340,226
750,2566.1,2570,4,2343,227
751,2568.5,2573,4,2346,227
752,2571.0,2576,5,2350,226
753,2573.1,2579,6,2353,226
754,2575.8,2582,6,2356,226
755,2579.1,2585,6,2359,226
756,2580.7272727272725,2588,7,2362,226
757,2591.75,2591,12799,2365,226
758,2600.9,2594,12793,2368,226
759,2604.3,2597,12793,2371,226
760,2606.6,2600,12793,2375,225
761,2608.8,2604,12795,2378,226
762,2610.9,2607,12796,2381,226
763,2613.3,2610,12797,2384,226
764,2616.2,2613,12797,2387,226
765,2619.7,2616,12796,2390,226
766,2622.6,2619,12796,2393,226
767,2625.3,2622,12797,2396,226
768,2627.8,2625,12797,2400,225
769,2630.8,2628,12797,2403,225
770,2634.0,2631,12797,2406,225
771,2636.7,2634,12797,2409,225
772,2638.9,2637,12798,2412,225
773,2640.8,2640,12799,2415,225
774,2643.1,2643,0,2418,225
775,2646.4,2646,0,2421,225
776,2649.7,2649,12799,2425,224
777,2663.0,2652,12789,2428,224
778,2659.9166666666665,2655,12795,2431,224
779,2671.6,2658,12786,2434,224
780,2674.1,2661,12787,2437,224
781,2676.3,2664,12788,2440,224
782,2678.2,2667,12789,2443,224
783,2680.6,2670,12789,2446,224
784,2682.9,2673,12790,2450,223
785,2684.7,2676,12791,2453,223
786,2687.2,2679,12792,2456,223
787,2689.4,2683,12794,2459,224
788,2691.9,2686,12794,2462,224
789,2694.4,2689,12795,2465,224
790,2696.9,2692,12795,2468,224
791,2699.0,2695,12796,2471,224
792,2701.1,2698,12797,2475,223
793,2703.2,2701,12798,2478,223
794,2705.3,2704,12799,2481,223
795,2707.2,2707,0,2484,223
796,2709.4,2710,1,2487,223
797,2712.3,2713,1,2490,223
798,2720.2,2716,12796,2493,223
799,2720.923076923077,2719,12798,2496,223
800,2734.8,2722,12787,2500,222
801,2737.0,2725,12788,2503,222
802,2738.9,2728,12789,2506,222
803,2740.6,2731,12790,2509,222
804,2742.3,2734,12792,2512,222
805,2744.1,2737,12793,2515,222
806,2746.0,2741,12795,2518,223
807,2748.2,2744,12796,2521,223
808,2750.6,2747,12796,2525,222
809,2752.3,2750,12798,2528,222
810,2754.2,2753,12799,2531,222
811,2756.0,2756,0,2534,222
812,2757.9,2759,1,2537,222
813,2760.2,2762,2,2540,222
814,2762.1,2765,3,2543,222
815,2763.8,2768,4,2546,222
816,2765.5,2771,6,2550,221
817,2767.7,2774,6,2553,221
818,2771.0,2777,6,2556,221
819,2777.6,2780,2,2559,221
820,2786.1,2783,12797,2562,221
821,2785.1666666666665,2786,1,2565,221
822,2795.2,2789,12794,2568,221
823,2797.4,2792,12795,2571,221
824,2799.3,2795,12796,2575,220
825,2801.1,2798,12797,2578,220
826,2802.7,2801,12798,2581,220
827,2805.1,2804,12799,2584,220
828,2807.6,2807,12799,2587,220
829,2810.2,2810,0,2590,220
830,2812.7,2813,0,2593,220
831,2814.9,2816,1,2596,220
832,2817.5,2819,2,2600,219
833,2819.8,2822,2,2603,219
834,2822.0,2825,3,2606,219
835,2824.0,2828,4,2609,219
836,2826.2,2831,5,2612,219
837,2828.3,2834,6,2615,219
838,2830.0,2837,7,2618,219
839,2832.3,2840,8,2621,219
840,2844.4285714285716,2843,12799,2625,218
841,2846.8,2846,12799,2628,218
842,2854.4,2849,12795,2631,218
843,2858.7,2852,12793,2634,218
844,2861.0,2854,12793,2637,217
845,2863.3,2857,12794,2640,217
846,2865.2,2860,12795,2643,217
847,2867.1,2863,12796,2646,217
848,2869.7,2866,12796,2650,216
849,2872.9,2869,12796,2653,216
850,2875.5,2872,12796,2656,216
851,2878.0,2875,12797,2659,216
852,2880.8,2877,12796,2662,215
853,2883.0,2880,12797,2665,215
854,2886.0,2883,12797,2668,215
855,2888.6,2886,12797,2671,215
856,2891.2,2889,12798,2675,214
857,2893.4,2892,12799,2678,214
858,2895.5,2895,0,2681,214
859,2897.4,2898,1,2684,214
860,2899.5,2901,2,2687,214
861,2901.8,2904,2,2690,214
862,2908.2,2906,12798,2693,213
863,2915.5,2909,12794,2696,213
864,2921.3,2912,12791,2700,212
865,2918.8333333333335,2915,12796,2703,212
866,2929.9,2918,12788,2706,212
867,2931.9,2921,12789,2709,212
868,2933.8,2924,12790,2712,212
869,2935.7,2926,12790,2715,211
870,2938.1,2929,12791,2718,211
871,2940.3,2932,12792,2721,211
872,2941.9,2935,12793,2725,210
873,2944.1,2938,12794,2728,210
874,2946.9,2941,12794,2731,210
875,2949.0,2944,12795,2734,210
876,2951.3,2947,12796,2737,210
877,2953.8,2950,12796,2740,210
878,2955.7,2953,12797,2743,210
879,2958.0,2956,12798,2746,210
880,2960.0,2959,12799,2750,209
881,2961.7,2962,0,2753,209
882,2963.7,2965,1,2756,209
883,2980.5333333333333,2967,12786,2759,208
884,2975.8,2970,12794,2762,208
885,2981.5,2973,12792,2765,208
886,2984.8,2976,12791,2768,208
887,2985.181818181818,2979,12794,2771,208
888,2992.5,2982,12790,2775,207
889,2994.7,2985,12790,2778,207
890,2996.5,2988,12792,2781,207
891,2998.4,2990,12792,2784,206
892,3000.1,2993,12793,2787,206
893,3001.7,2996,12794,2790,206
894,3003.9,2999,12795,2793,206
895,3005.6,3002,12796,2796,206
896,3007.2,3005,12798,2800,205
897,3009.1,3008,12799,2803,205
898,3011.0,3011,0,2806,205
899,3012.6,3014,1,2809,205
900,3014.5,3017,2,2812,205
901,3016.2,3020,4,2815,205
902,3018.2,3023,5,2818,205
903,3020.1,3026,6,2821,205
904,3022.1,3029,7,2825,204
905,3028.909090909091,3032,3,2828,204
906,3030.2,3034,4,2831,203
907,3035.4,3037,2,2834,203
908,3038.9,3040,1,2837,203
909,3036.5,3043,6,2840,203
910,3036.3571428571427,3046,10,2843,203
911,3052.9,3049,12796,2846,203
912,3055.0,3051,12796,2850,201
913,3057.0,3054,12797,2853,201
914,3059.2,3057,12798,2856,201
915,3061.5,3060,12798,2859,201
916,3063.6,3063,12799,2862,201
917,3065.6,3066,0,2865,201
918,3067.7,3069,1,2868,201
919,3070.0,3072,2,2871,201
920,3072.9,3075,2,2875,200
921,3075.4,3077,2,2878,199
922,3077.3,3080,3,2881,199
923,3079.0,3083,4,2884,199
924,3080.8,3086,5,2887,199
925,3082.8,3089,6,2890,199
926,3089.1111111111113,3092,3,2893,199
927,3087.2,3095,8,2896,199
928,3093.2,3097,4,2900,197
929,3101.3,3100,12799,2903,197
930,3105.5,3103,12798,2906,197
931,3108.5,3106,12798,2909,197
932,3112.7,3108,12795,2912,196
933,3116.4,3111,12795,2915,196
934,3119.1,3114,12795,2918,196
935,3121.6,3117,12795,2921,196
936,3123.8,3119,12795,2925,194
937,3126.2,3122,12796,2928,194
938,3128.6,3125,12796,2931,194
939,3130.6,3128,12797,2934,194
940,3132.9,3130,12797,2937,193
941,3135.9,3133,12797,2940,193
942,3138.7,3136,12797,2943,193
943,3141.0,3139,12798,2946,193
944,3143.3,3142,12799,2950,192
945,3145.4,3145,0,2953,192
946,3147.9,3147,12799,2956,191
947,3150.2,3150,0,2959,191
948,3152.2,3153,1,2962,191
949,3143.125,3156,13,2965,191
950,3170.214285714286,3158,12788,2968,190
951,3162.1,3161,12799,2971,190
952,3166.7,3164,12797,2975,189
953,3160.214285714286,3167,7,2978,189
954,3174.7,3169,12794,2981,188
955,3180.9,3172,12791,2984,188
956,3185.9,3175,12789,2987,188
957,3188.1,3178,12790,2990,188
958,3190.1,3181,12791,2993,188
959,3191.7,3183,12791,2996,187
960,3193.7,3186,12792,3000,186
961,3195.4,3189,12794,3003,186
962,3198.0,3192,12794,3006,186
963,3200.4,3195,12795,3009,186
964,3202.7,3197,12794,3012,185
965,3204.7,3200,12795,3015,185
966,3206.7,3203,12796,3018,185
967,3208.8,3206,12797,3021,185
968,3210.9,3209,12798,3025,184
969,3213.3,3212,12799,3028,184
970,3215.3,3215,0,3031,184
971,3217.5,3218,0,3034,184
972,3219.5,3220,0,3037,183
973,3228.4545454545455,3223,12795,3040,183
974,3232.4,3226,12794,3043,183
975,3236.2,3229,12793,3046,183
976,3236.181818181818,3232,12796,3050,182
977,3241.9,3234,12792,3053,181
978,3245.7,3237,12791,3056,181
979,3249.4,3240,12791,3059,181
980,3251.6,3243,12791,3062,181
981,3253.2,3246,12793,3065,181
982,3255.2,3249,12794,3068,181
983,3257.4,3251,12794,3071,180
984,3259.4,3254,12795,3075,179
985,3260.8,3257,12796,3078,179
986,3262.4,3260,12798,3081,179
987,3263.7,3263,12799,3084,179
988,3265.4,3266,1,3087,179
989,3266.8,3269,2,3090,179
990,3268.9,3271,2,3093,178
991,3271.0,3274,3,3096,178
992,3272.7,3277,4,3100,177
993,3274.5,3280,6,3103,177
994,3276.3,3283,7,3106,177
995,3278.5,3286,8,3109,177
996,3287.0,3288,1,3112,176
997,3288.4,3291,3,3115,176
998,3291.4,3294,3,3118,176
999,3292.0,3297,5,3121,176
1000,3297.4,3299,2,3125,174
1001,3299.181818181818,3302,3,3128,174
1002,3304.0,3305,1,3131,174
1003,3310.9,3308,12797,3134,174
1004,3313.6,3311,12797,3137,174
1005,3316.0,3314,12798,3140,174
1006,3317.8,3316,12798,3143,173
1007,3320.0,3319,12799,3146,173
1008,3322.0,3322,0,3150,172
1009,3324.2,3325,1,3153,172
1010,3326.3,3328,2,3156,172
1011,3328.5,3330,2,3159,171
1012,3330.8,3333,2,3162,171
1013,3333.1,3336,3,3165,171
1014,3335.0,3339,4,3168,171
1015,3336.8,3342,5,3171,171
1016,3338.5,3345,6,3175,170
1017,3340.6,3347,6,3178,169
1018,3365.4375,3350,12785,3181,169
1019,3353.9,3353,12799,3184,169
1020,3357.2,3356,12799,3187,169
1021,3360.1,3358,12798,3190,168
1022,3359.4545454545455,3361,2,3193,168
1023,3365.4,3364,12799,3196,168
1024,3365.0,3366,1,3200,166
1025,3365.25,3369,4,3203,166
1026,3376.7,3372,12795,3206,166
1027,3379.1,3375,12796,3209,166
1028,3381.6,3377,12795,3212,165
1029,3384.0,3380,12796,3215,165
1030,3385.9,3383,12797,3218,165
1031,3388.0,3386,12798,3221,165
1032,3390.2,3388,12798,3225,163
1033,3393.0,3391,12798,3228,163
1034,3395.5,3394,12798,3231,163
1035,3397.8,3397,12799,3234,163
1036,3400.0,3400,0,3237,163
1037,3401.8,3402,0,3240,162
1038,3404.1,3405,1,3243,162
1039,3406.6,3408,1,3246,162
1040,3404.222222222222,3411,7,3250,161
1041,3428.4666666666667,3413,12785,3253,160
1042,3417.9,3416,12798,3256,160
1043,3421.5,3419,12798,3259,160
1044,3423.9,3421,12797,3262,159
1045,3426.9,3424,12797,3265,159
1046,3430.5,3427,12796,3268,159
1047,3423.5714285714284,3430,6,3271,159
1048,3433.1666666666665,3433,0,3275,158
1049,3444.5,3435,12790,3278,157
1050,3446.2,3438,12792,3281,157
1051,3448.4,3441,12793,3284,157
1052,3450.1,3444,12794,3287,157
1053,3452.3,3447,12795,3290,157
1054,3455.0,3449,12794,3293,156
1055,3457.0,3452,12795,3296,156
1056,3458.8,3455,12796,3300,155
1057,3460.9,3458,12797,3303,155
1058,3463.1,3461,12798,3306,155
1059,3465.6,3464,12798,3309,155
1060,3467.8,3467,12799,3312,155
1061,3469.5,3469,0,3315,154
1062,3471.8,3472,0,3318,154
1063,3474.0,3475,1,3321,154
1064,3479.8,3478,12798,3325,153
1065,3486.7,3481,12794,3328,153
1066,3490.4,3484,12794,3331,153
1067,3493.0,3486,12793,3334,152
1068,3492.3636363636365,3489,12797,3337,152
1069,3497.6,3492,12794,3340,152
1070,3500.8,3495,12794,3343,152
1071,3497.5,3497,0,3346,151
1072,3507.8,3500,12792,3350,150
1073,3509.8,3503,12793,3353,150
1074,3511.7,3506,12794,3356,150
1075,3513.8,3509,12795,3359,150
1076,3515.8,3512,12796,3362,150
1077,3517.4,3514,12797,3365,149
1078,3518.7,3517,12798,3368,149
1079,3520.4,3520,0,3371,149
1080,3521.7,3523,1,3375,148
1081,3523.4,3526,3,3378,148
1082,3525.4,3529,4,3381,148
1083,3527.3,3532,5,3384,148
1084,3529.1,3534,5,3387,147
1085,3531.2,3537,6,3390,147
1086,3533.5,3540,6,3393,147
1087,3537.7,3543,5,3396,147
1088,3542.4,3546,4,3400,146
1089,3545.2,3549,4,3403,146
1090,3547.7,3551,3,3406,145
1091,3550.7,3554,3,3409,145
1092,3553.8,3557,3,3412,145
1093,3544.4666666666667,3560,16,3415,145
1094,3563.3,3563,0,3418,145
1095,3563.909090909091,3566,2,3421,145
1096,3570.6,3569,12798,3425,144
1097,3572.8,3571,12798,3428,143
1098,3574.9,3574,12799,3431,143
1099,3577.0,3577,0,3434,143
1100,3578.9,3580,1,3437,143
1101,3581.2,3583,2,3440,143
1102,3583.7,3586,2,3443,143
1103,3585.7,3589,3,3446,143
1104,3587.9,3591,3,3450,141
1105,3590.1,3594,4,3453,141
1106,3591.9,3597,5,3456,141
1107,3593.9,3600,6,3459,141
1108,3595.9,3603,7,3462,141
1109,3615.0714285714284,3605,12790,3465,140
1110,3609.0,3608,12799,3468,140
1111,3612.8,3611,12798,3471,140
1112,3614.9,3614,12799,3475,139
1113,3617.8,3617,12799,3478,139
1114,3620.5,3619,12798,3481,138
1115,3623.3,3622,12799,3484,138
1116,3627.7,3625,12797,3487,138
1117,3632.0,3628,12796,3490,138
1118,3634.7,3630,12795,3493,137
1119,3637.1,3633,12796,3496,137
1120,3639.3,3636,12797,3500,136
1121,3641.6,3639,12797,3503,136
1122,3643.7,3642,12798,3506,136
1123,3645.9,3644,12798,3509,135
1124,3648.7,3647,12798,3512,135
1125,3651.2,3650,12799,3515,135
1126,3653.4,3653,0,3518,135
1127,3655.5,3656,0,3521,135
1128,3657.6,3659,1,3525,134
1129,3660.1,3661,1,3528,133
1130,3662.4,3664,2,3531,133
1131,3664.9,3667,2,3534,133
1132,3669.3,3670,1,3537,133
1133,3674.5,3673,12798,3540,133
1134,3677.6,3675,12797,3543,132
1135,3679.7,3678,12798,3546,132
1136,3682.6,3681,12798,3550,131
1137,3685.9,3684,12798,3553,131
1138,3690.1,3686,12796,3556,130
1139,3692.2727272727275,3689,12797,3559,130
1140,3700.5,3692,12792,3562,130
1141,3702.6,3695,12792,3565,130
1142,3704.4,3698,12794,3568,130
1143,3706.4,3701,12795,3571,130
1144,3708.5,3704,12796,3575,129
1145,3711.3,3707,12796,3578,129
1146,3713.6,3709,12795,3581,128
1147,3715.6,3712,12796,3584,128
1148,3717.7,3715,12797,3587,128
1149,3719.9,3718,12798,3590,128
1150,3722.0,3721,12799,3593,128
1151,3723.9,3724,0,3596,128
1152,3726.4,3727,1,3600,127
1153,3728.9,3730,1,3603,127
1154,3751.705882352941,3733,12781,3606,127
1155,3745.5454545454545,3736,12790,3609,127
1156,3744.8,3739,12794,3612,127
1157,3747.1,3741,12794,3615,126
1158,3749.1,3744,12795,3618,126
1159,3748.090909090909,3747,12799,3621,126
1160,3755.2,3750,12795,3625,125
1161,3759.1,3753,12794,3628,125
1162,3754.75,3756,1,3631,125
1163,3765.2,3759,12794,3634,125
1164,3767.1,3762,12795,3637,125
1165,3769.4,3765,12796,3640,125
1166,3771.3,3768,12797,3643,125
1167,3773.1,3771,12798,3646,125
1168,3774.5,3774,0,3650,124
1169,3776.2,3777,1,3653,124
1170,3777.6,3779,1,3656,123
1171,3779.4,3782,3,3659,123
1172,3781.0,3785,4,3662,123
1173,3782.9,3788,5,3665,123
1174,3785.2,3791,6,3668,123
1175,3787.5,3794,6,3671,123
1176,3790.1,3797,7,3675,122
1177,3798.818181818182,3800,1,3678,122
1178,3799.1,3803,4,3681,122
1179,3801.4,3806,5,3684,122
1180,3804.3,3809,5,3687,122
1181,3796.8,3812,15,3690,122
1182,3811.1,3814,3,3693,121
1183,3816.6,3817,0,3696,121
1184,3811.4615384615386,3820,9,3700,120
1185,3824.4,3823,12799,3703,120
1186,3827.0,3826,12799,3706,120
1187,3829.7,3829,12799,3709,120
1188,3832.0,3832,0,3712,120
1189,3834.1,3835,1,3715,120
1190,3836.3,3838,2,3718,120
1191,3838.7,3841,2,3721,120
1192,3841.0,3844,3,3725,119
1193,3842.8,3847,4,3728,119
1194,3845.1,3850,5,3731,119
1195,3847.2,3853,6,3734,119
1196,3849.2,3855,6,3737,118
1197,3851.1,3858,7,3740,118
1198,3853.5,3861,8,3743,118
1199,3859.6,3864,4,3746,118
1200,3866.9,3867,0,3750,117
1201,3870.6,3870,12799,3753,117
1202,3873.7,3873,12799,3756,117
1203,3876.5,3876,0,3759,117
1204,3879.6,3879,12799,3762,117
1205,3884.0,3882,12798,3765,117
1206,3887.8,3884,12796,3768,116
1207,3890.5,3887,12796,3771,116
1208,3893.7,3890,12796,3775,115
1209,3896.2,3893,12797,3778,115
1210,3898.4,3896,12798,3781,115
1211,3900.6,3899,12798,3784,115
1212,3903.0,3902,12799,3787,115
1213,3905.5,3905,0,3790,115
1214,3907.8,3908,0,3793,115
1215,3910.0,3911,1,3796,115
1216,3912.6,3914,1,3800,114
1217,3915.0,3917,2,3803,114
1218,3917.3,3920,3,3806,114
1219,3919.9,3922,2,3809,113
1220,3927.818181818182,3925,12797,3812,113
1221,3931.2727272727275,3928,12797,3815,113
1222,3932.7,3931,12798,3818,113
1223,3935.7,3934,12798,3821,113
1224,3938.8,3937,12798,3825,112
1225,3941.7,3940,12798,3828,112
1226,3940.6363636363635,3943,2,3831,112
1227,3947.6363636363635,3946,12798,3834,112
1228,3956.6,3949,12792,3837,112
1229,3959.1,3952,12793,3840,112
1230,3961.0,3955,12794,3843,112
1231,3963.0,3958,12795,3846,112
1232,3965.2,3961,12796,3850,111
1233,3967.6,3964,12796,3853,111
1234,3969.9,3967,12797,3856,111
1235,3971.9,3970,12798,3859,111
1236,3974.1,3973,12799,3862,111
1237,3976.5,3976,0,3865,111
1238,3978.9,3979,0,3868,111
1239,3981.3,3982,1,3871,111
1240,3983.5,3985,2,3875,110
1241,3985.9,3988,2,3878,110
1242,4004.285714285714,3991,12787,3881,110
1243,3998.7,3994,12795,3884,110
1244,4002.2,3997,12795,3887,110
1245,4005.5,4000,12794,3890,110
1246,4008.3,4003,12795,3893,110
1247,4011.1,4006,12795,3896,110
1248,4015.2,4009,12794,3900,109
1249,4018.9,4013,12794,3903,110
1250,4021.1,4016,12795,3906,110
1251,4023.5,4019,12796,3909,110
1252,4025.7,4022,12796,3912,110
1253,4027.5,4025,12798,3915,110
1254,4029.2,4028,12799,3918,110
1255,4031.0,4031,0,3921,110
1256,4032.4,4034,2,3925,109
1257,4034.1,4037,3,3928,109
1258,4035.9,4040,4,3931,109
1259,4038.0,4043,5,3934,109
1260,4040.1,4046,6,3937,109
1261,4042.4,4049,7,3940,109
1262,4044.4,4052,8,3943,109
1263,4057.6923076923076,4055,12797,3946,109
1264,4052.6,4059,6,3950,109
1265,4057.1,4062,5,3953,109
1266,4060.5,4065,4,3956,109
1267,4063.7,4068,4,3959,109
1268,4067.1,4071,4,3962,109
1269,4068.6363636363635,4074,5,3965,109
1270,4078.0,4077,12799,3968,109
1271,4080.5,4080,0,3971,109
1272,4083.8,4083,12799,3975,108
1273,4086.0,4086,0,3978,108
1274,4088.1,4089,1,3981,108
1275,4090.4,4092,2,3984,108
1276,4092.7,4095,2,3987,108
1277,4095.3,4098,3,3990,108
1278,4097.5,4101,4,3993,108
1279,4099.7,4104,4,3996,108
1280,4102.2,4108,6,4000,108
1281,4104.4,4111,7,4003,108
1282,4106.4,4114,8,4006,108
1283,4108.4,4117,9,4009,108
1284,4133.588235294118,4120,12786,4012,108
1285,4120.0,4123,3,4015,108
1286,4125.7,4126,0,4018,108
1287,4129.1,4129,0,4021,108
1288,4132.5,4132,0,4025,107
1289,4132.818181818182,4135,2,4028,107
1290,4141.4,4138,12797,4031,107
1291,4144.2,4141,12797,4034,107
1292,4146.7,4144,12797,4037,107
1293,4149.9,4147,12797,4040,107
1294,4152.5,4150,12798,4043,107
1295,4155.0,4153,12798,4046,107
1296,4157.5,4156,12798,4050,106
1297,4159.9,4160,0,4053,107
1298,4162.8,4163,0,4056,107
1299,4165.5,4166,0,4059,107
1300,4168.2,4169,1,4062,107
1301,4170.8,4172,1,4065,107
1302,4173.1,4175,2,4068,107
1303,4175.5,4178,2,4071,107
1304,4177.8,4181,3,4075,106
1305,4195.0,4184,12789,4078,106
1306,4187.4,4187,0,4081,106
1307,4192.3,4190,12798,4084,106
1308,4196.1,4194,12798,4087,107
1309,4200.0,4197,12797,4090,107
1310,4193.214285714285,4200,7,4093,107
1311,4211.3,4203,12792,4096,107
1312,4213.3,4206,12793,4100,106
1313,4215.6,4209,12793,4103,106
1314,4217.4,4212,12795,4106,106
1315,4219.5,4215,12796,4109,106
1316,4222.4,4218,12796,4112,106
1317,4225.1,4222,12797,4115,107
1318,4227.6,4225,12797,4118,107
1319,4229.9,4228,12798,4121,107
1320,4232.1,4231,12799,4125,106
1321,4234.5,4234,0,4128,106
1322,4237.1,4237,0,4131,106
1323,4239.6,4241,1,4134,107
1324,4241.7,4244,2,4137,107
1325,4244.3,4247,3,4140,107
1326,4251.3,4250,12799,4143,107
1327,4258.4,4254,12796,4146,108
1328,4261.9,4257,12795,4150,107
1329,4265.7,4260,12794,4153,107
1330,4270.3,4263,12793,4156,107
1331,4274.1,4267,12793,4159,108
1332,4276.0,4270,12794,4162,108
1333,4278.1,4273,12795,4165,108
1334,4280.2,4276,12796,4168,108
1335,4282.4,4279,12797,4171,108
1336,4284.6,4283,12798,4175,108
1337,4286.6,4286,12799,4178,108
1338,4288.4,4289,1,4181,108
1339,4290.1,4292,2,4184,108
1340,4291.8,4295,3,4187,108
1341,4293.7,4299,5,4190,109
1342,4296.1,4302,6,4193,109
1343,4298.4,4305,7,4196,109
1344,4300.7,4308,7,4200,108
1345,4303.0,4312,9,4203,109
1346,4312.090909090909,4315,3,4206,109
1347,4313.3,4318,5,4209,109
1348,4312.333333333333,4322,10,4212,110
1349,4322.0,4325,3,4215,110
1350,4314.466666666666,4328,14,4218,110
1351,4333.3,4331,12798,4221,110
1352,4335.7,4334,12798,4225,109
1353,4338.0,4338,0,4228,110
1354,4340.5,4341,0,4231,110
1355,4342.9,4344,1,4234,110
1356,4345.2,4347,2,4237,110
1357,4348.4,4350,2,4240,110
1358,4351.0,4354,3,4243,111
1359,4353.6,4357,3,4246,111
1360,4356.0,4360,4,4250,110
1361,4358.4,4363,5,4253,110
1362,4360.4,4366,6,4256,110
1363,4362.5,4370,8,4259,111
1364,4365.1,4373,8,4262,111
1365,4371.636363636364,4376,4,4265,111
1366,4380.454545454545,4379,12799,4268,111
1367,4383.5,4383,0,4271,112
1368,4386.9,4386,12799,4275,111
1369,4390.9,4389,12798,4278,111
1370,4391.636363636364,4392,0,4281,111
1371,4399.5,4396,12796,4284,112
1372,4402.2,4399,12797,4287,112
1373,4404.8,4402,12797,4290,112
1374,4407.3,4405,12798,4293,112
1375,4409.9,4409,12799,4296,113
1376,4412.6,4412,12799,4300,112
1377,4415.8,4415,12799,4303,112
1378,4419.1,4418,12799,4306,112
1379,4421.9,4421,12799,4309,112
1380,4424.5,4425,0,4312,113
1381,4427.4,4428,1,4315,113
1382,4429.8,4431,1,4318,113
1383,4432.3,4434,2,4321,113
1384,4435.1,4438,3,4325,113
1385,4449.615384615385,4441,12791,4328,113
1386,4446.3,4444,12798,4331,113
1387,4450.8,4448,12797,4334,114
1388,4455.2,4451,12796,4337,114
1389,4451.615384615385,4454,2,4340,114
1390,4466.8,4458,12791,4343,115
1391,4469.4,4461,12792,4346,115
1392,4471.9,4464,12792,4350,114
1393,4473.7,4467,12793,4353,114
1394,4475.9,4471,12795,4356,115
1395,4478.3,4474,12796,4359,115
1396,4480.9,4477,12796,4362,115
1397,4483.7,4480,12796,4365,115
1398,4486.1,4484,12798,4368,116
1399,4488.9,4487,12798,4371,116
1400,4491.5,4490,12798,4375,115
1401,4494.2,4494,0,4378,116
1402,4496.4,4497,1,4381,116
1403,4498.4,4500,2,4384,116
1404,4500.8,4504,3,4387,117
1405,4508.4,4507,12799,4390,117
1406,4513.545454545455,4511,12797,4393,118
1407,4521.0,4514,12793,4396,118
1408,4518.166666666667,4518,0,4400,118
1409,4529.6,4521,12791,4403,118
1410,4531.8,4524,12792,4406,118
1411,4533.9,4528,12794,4409,119
1412,4535.9,4531,12795,4412,119
1413,4538.4,4535,12797,4415,120
1414,4540.7,4538,12797,4418,120
1415,4542.8,4541,12798,4421,120
1416,4544.5,4545,0,4425,120
1417,4546.3,4548,2,4428,120
1418,4548.3,4551,3,4431,120
1419,4550.7,4555,4,4434,121
1420,4553.0,4558,5,4437,121
1421,4555.2,4562,7,4440,122
1422,4557.4,4565,8,4443,122
1423,4560.0,4568,8,4446,122
1424,4566.3,4572,6,4450,122
1425,4572.5,4575,2,4453,122
1426,4576.5,4579,2,4456,123
1427,4575.25,4582,7,4459,123
1428,4588.5,4586,12798,4462,124
1429,4591.1,4589,12798,4465,124
1430,4593.3,4592,12799,4468,124
1431,4595.8,4596,0,4471,125
1432,4598.3,4599,1,4475,124
1433,4601.1,4602,1,4478,124
1434,4604.2,4606,2,4481,125
1435,4607.1,4609,2,4484,125
1436,4610.0,4612,2,4487,125
1437,4612.4,4616,4,4490,126
1438,4614.4,4619,5,4493,126
1439,4616.6,4623,6,4496,127
1440,4618.7,4626,7,4500,126
1441,4621.2,4629,8,4503,126
1442,4624.6,4633,8,4506,127
1443,4633.0,4636,3,4509,127
1444,4641.1,4640,12799,4512,128
1445,4645.7,4643,12797,4515,128
1446,4646.0,4646,0,4518,128
1447,4653.8,4650,12796,4521,129
1448,4656.7,4653,12796,4525,128
1449,4659.7,4657,12797,4528,129
1450,4662.8,4660,12797,4531,129
1451,4665.5,4663,12798,4534,129
1452,4668.2,4667,12799,4537,130
1453,4671.2,4670,12799,4540,130
1454,4674.6,4673,12798,4543,130
1455,4678.0,4677,12799,4546,131
1456,4681.2,4680,12799,4550,130
1457,4683.9,4683,12799,4553,130
1458,4686.5,4687,0,4556,131
1459,4688.8,4690,1,4559,131
1460,4691.0,4694,3,4562,132
1461,4693.5,4697,4,4565,132
1462,4700.0,4700,0,4568,132
1463,4708.4,4704,12796,4571,133
1464,4715.1,4707,12792,4575,132
1465,4713.0,4711,12798,4578,133
1466,4723.6,4714,12790,4581,133
1467,4726.0,4718,12792,4584,134
1468,4728.4,4721,12793,4587,134
1469,4730.9,4725,12794,4590,135
1470,4733.4,4728,12795,4593,135
1471,4736.2,4731,12795,4596,135
1472,4739.1,4735,12796,4600,135
1473,4741.9,4738,12796,4603,135
1474,4744.1,4742,12798,4606,136
1475,4746.7,4745,12798,4609,136
1476,4749.4,4748,12799,4612,136
1477,4751.8,4752,0,4615,137
1478,4754.2,4755,1,4618,137
1479,4756.8,4759,2,4621,138
1480,4767.272727272727,4762,12795,4625,137
1481,4772.5,4766,12794,4628,138
1482,4776.4,4769,12793,4631,138
1483,4774.083333333333,4773,12799,4634,139
1484,4785.6,4776,12790,4637,139
1485,4788.2,4780,12792,4640,140
1486,4790.2,4783,12793,4643,140
1487,4792.1,4787,12795,4646,141
1488,4794.4,4790,12796,4650,140
1489,4796.8,4794,12797,4653,141
1490,4799.0,4797,12798,4656,141
1491,4801.1,4801,0,4659,142
1492,4803.4,4804,1,4662,142
1493,4805.4,4808,3,4665,143
1494,4807.8,4811,3,4668,143
1495,4809.8,4815,5,4671,144
1496,4811.8,4818,6,4675,143
1497,4814.4,4822,8,4678,144
1498,4825.5,4825,0,4681,144
1499,4825.1,4829,4,4684,145
1500,4831.4,4832,1,4687,145
1501,4837.1,4836,12799,4690,146
1502,4842.7,4839,12796,4693,146
1503,4845.8,4843,12797,4696,147
1504,4848.4,4846,12798,4700,146
1505,4851.3,4850,12799,4703,147
1506,4853.9,4853,12799,4706,147
1507,4856.6,4857,0,4709,148
1508,4859.1,4860,1,4712,148
1509,4861.8,4864,2,4715,149
1510,4864.7,4867,2,4718,149
1511,4867.5,4870,2,4721,149
1512,4870.2,4874,4,4725,149
1513,4872.8,4877,4,4728,149
1514,4874.9,4881,6,4731,150
1515,4877.2,4884,7,4734,150
1516,4879.9,4888,8,4737,151
1517,4892.090909090909,4891,12799,4740,151
1518,4896.4,4895,12799,4743,152
1519,4900.9,4898,12797,4746,152
1520,4898.5,4902,4,4750,152
1521,4910.3,4905,12795,4753,152
1522,4912.9,4908,12795,4756,152
1523,4915.6,4912,12796,4759,153
1524,4918.4,4915,12797,4762,153
1525,4921.5,4919,12798,4765,154
1526,4925.1,4922,12797,4768,154
1527,4928.3,4926,12798,4771,155
1528,4931.4,4929,12798,4775,154
1529,4934.3,4933,12799,4778,155
1530,4936.8,4936,12799,4781,155
1531,4939.7,4939,12799,4784,155
1532,4942.5,4943,0,4787,156
1533,4945.1,4946,1,4790,156
1534,4948.0,4950,2,4793,157
1535,4953.3,4953,0,4796,157
1536,4960.4,4957,12797,4800,157
1537,4965.1,4960,12795,4803,157
1538,4970.6,4964,12793,4806,158
1539,4976.8,4967,12790,4809,158
1540,4980.7,4971,12790,4812,159
1541,4983.1,4974,12791,4815,159
1542,4985.2,4978,12793,4818,160
1543,4987.6,4981,12793,4821,160
1544,4989.9,4985,12795,4825,160
1545,4992.3,4988,12796,4828,160
1546,4995.7,4991,12795,4831,160
1547,4998.5,4995,12796,4834,161
1548,5001.6,4998,12796,4837,161
1549,5004.0,5002,12798,4840,162
1550,5006.4,5005,12799,4843,162
1551,5008.7,5009,0,4846,163
1552,5011.3,5012,1,4850,162
1553,5018.4,5016,12798,4853,163
1554,5026.6,5019,12792,4856,163
1555,5030.7,5023,12792,4859,164
1556,5034.4,5026,12792,4862,164
1557,5038.9,5030,12791,4865,165
1558,5042.4,5033,12791,4868,165
1559,5044.7,5037,12792,4871,166
1560,5046.9,5040,12793,4875,165
1561,5048.9,5044,12795,4878,166
1562,5051.3,5047,12796,4881,166
1563,5053.8,5051,12797,4884,167
1564,5056.1,5054,12798,4887,167
1565,5058.0,5058,0,4890,168
1566,5060.0,5061,1,4893,168
1567,5062.3,5065,3,4896,169
1568,5064.4,5068,4,4900,168
1569,5066.6,5072,5,4903,169
1570,5069.2,5075,6,4906,169
1571,5076.363636363636,5079,3,4909,170
1572,5079.0,5082,3,4912,170
1573,5084.7,5086,1,4915,171
1574,5088.3,5089,1,4918,171
1575,5094.0,5093,12799,4921,172
1576,5089.461538461538,5096,7,4925,171
1577,5103.6,5100,12796,4928,172
1578,5106.1,5103,12797,4931,172
1579,5108.6,5107,12798,4934,173
1580,5111.2,5110,12799,4937,173
1581,5113.8,5114,0,4940,174
1582,5116.6,5117,0,4943,174
1583,5119.7,5121,1,4946,175
1584,5122.6,5124,1,4950,174
1585,5125.2,5128,3,4953,175
1586,5127.4,5131,4,4956,175
1587,5129.7,5134,4,4959,175
1588,5131.9,5138,6,4962,176
1589,5134.6,5141,6,4965,176
1590,5143.2,5145,2,4968,177
1591,5151.6,5148,12796,4971,177
1592,5154.5,5152,12798,4975,177
1593,5158.8,5155,12796,4978,177
1594,5163.6,5158,12794,4981,177
1595,5167.5,5162,12794,4984,178
1596,5170.8,5165,12794,4987,178
1597,5173.7,5169,12795,4990,179
1598,5176.6,5172,12795,4993,179
1599,5179.3,5176,12797,4996,180
1600,5182.0,5179,12797,5000,179
1601,5185.0,5183,12798,5003,180
1602,5188.0,5186,12798,5006,180
1603,5191.0,5189,12798,5009,180
1604,5193.8,5193,12799,5012,181
1605,5197.0,5196,12799,5015,181
1606,5199.6,5200,0,5018,182
1607,5202.2,5203,1,5021,182
1608,5206.6,5206,12799,5025,181
1609,5213.2,5210,12797,5028,182
1610,5218.1,5213,12795,5031,182
1611,5222.2,5217,12795,5034,183
1612,5227.3,5220,12793,5037,183
1613,5221.0,5224,3,5040,184
1614,5237.1,5227,12790,5043,184
1615,5239.4,5230,12791,5046,184
1616,5241.9,5234,12792,5050,184
1617,5244.3,5237,12793,5053,184
1618,5247.0,5241,12794,5056,185
1619,5249.6,5244,12794,5059,185
1620,5252.7,5247,12794,5062,185
1621,5255.2,5251,12796,5065,186
1622,5257.6,5254,12796,5068,186
1623,5259.9,5258,12798,5071,187
1624,5262.6,5261,12798,5075,186
1625,5265.6,5264,12798,5078,186
1626,5282.571428571428,5268,12785,5081,187
1627,5278.7,5271,12792,5084,187
1628,5281.363636363636,5275,12794,5087,188
1629,5286.6,5278,12791,5090,188
1630,5289.5,5282,12792,5093,189
1631,5293.9,5285,12791,5096,189
1632,5298.1,5288,12790,5100,188
1633,5301.4,5292,12791,5103,189
1634,5303.6,5295,12791,5106,189
1635,5305.7,5299,12793,5109,190
1636,5308.1,5302,12794,5112,190
1637,5310.1,5306,12796,5115,191
1638,5312.1,5309,12797,5118,191
1639,5313.9,5313,12799,5121,192
1640,5315.7,5316,0,5125,191
1641,5317.8,5320,2,5128,192
1642,5320.0,5323,3,5131,192
1643,5322.2,5326,4,5134,192
1644,5324.5,5330,6,5137,193
1645,5329.3,5333,4,5140,193
1646,5335.5,5337,2,5143,194
1647,5340.2,5340,0,5146,194
1648,5342.9,5344,1,5150,194
1649,5345.6,5347,1,5153,194
1650,5347.090909090909,5350,3,5156,194
1651,5348.416666666667,5354,6,5159,195
1652,5360.7,5357,12796,5162,195
1653,5363.4,5361,12798,5165,196
1654,5366.7,5364,12797,5168,196
1655,5369.4,5368,12799,5171,197
1656,5372.1,5371,12799,5175,196
1657,5374.7,5374,12799,5178,196
1658,5377.1,5378,1,5181,197
1659,5379.4,5381,2,5184,197
1660,5382.2,5384,2,5187,197
1661,5384.9,5387,2,5190,197
1662,5386.9,5391,4,5193,198
1663,5402.076923076923,5394,12792,5196,198
1664,5397.7,5397,12799,5200,197
1665,5404.7,5401,12796,5203,198
1666,5404.818181818182,5404,12799,5206,198
1667,5411.1,5407,12796,5209,198
1668,5414.5,5411,12796,5212,199
1669,5418.1,5414,12796,5215,199
1670,5417.272727272727,5417,0,5218,199
1671,5426.6,5421,12794,5221,200
1672,5429.6,5424,12794,5225,199
1673,5432.4,5427,12795,5228,199
1674,5435.7,5431,12795,5231,200
1675,5438.4,5434,12796,5234,200
1676,5441.1,5437,12796,5237,200
1677,5443.7,5441,12797,5240,201
1678,5446.0,5444,12798,5243,201
1679,5448.8,5447,12798,5246,201
1680,5451.3,5451,0,5250,201
1681,5454.0,5454,0,5253,201
1682,5457.3,5457,0,5256,201
1683,5463.2,5460,12797,5259,201
1684,5468.4,5464,12796,5262,202
1685,5463.461538461538,5467,4,5265,202
1686,5475.3,5470,12795,5268,202
1687,5477.9,5474,12796,5271,203
1688,5481.6,5477,12795,5275,202
1689,5487.4,5480,12793,5278,202
1690,5492.5,5484,12792,5281,203
1691,5495.8,5487,12791,5284,203
1692,5498.2,5490,12792,5287,203
1693,5500.5,5493,12792,5290,203
1694,5503.2,5497,12794,5293,204
1695,5505.9,5500,12794,5296,204
1696,5508.5,5503,12794,5300,203
1697,5511.0,5506,12795,5303,203
1698,5513.2,5510,12797,5306,204
1699,5515.5,5513,12798,5309,204
1700,5518.1,5516,12798,5312,204
1701,5524.727272727273,5520,12795,5315,205
1702,5528.4,5523,12795,5318,205
1703,5536.1,5526,12790,5321,205
1704,5539.6,5529,12789,5325,204
1705,5542.3,5533,12791,5328,205
1706,5544.3,5536,12792,5331,205
1707,5546.5,5539,12792,5334,205
1708,5546.272727272727,5543,12797,5337,206
1709,5554.6,5546,12791,5340,206
1710,5558.3,5549,12791,5343,206
1711,5561.2,5553,12792,5346,207
1712,5563.3,5556,12793,5350,206
1713,5564.9,5559,12794,5353,206
1714,5566.6,5563,12796,5356,207
1715,5568.6,5566,12797,5359,207
1716,5570.7,5569,12798,5362,207
1717,5572.7,5573,0,5365,208
1718,5574.5,5576,2,5368,208
1719,5576.6,5579,2,5371,208
1720,5578.7,5582,3,5375,207
1721,5583.3,5586,3,5378,208
1722,5588.4,5589,1,5381,208
1723,5591.6,5592,0,5384,208
1724,5595.0,5596,1,5387,209
1725,5598.4,5599,1,5390,209
1726,5601.1,5602,1,5393,209
1727,5603.3,5606,3,5396,210
1728,5601.083333333333,5609,8,5400,209
1729,5599.5,5612,12,5403,209
1730,5608.833333333333,5615,6,5406,209
1731,5622.2,5619,12797,5409,210
1732,5624.9,5622,12797,5412,210
1733,5627.5,5625,12798,5415,210
1734,5629.6,5628,12798,5418,210
1735,5632.0,5631,12799,5421,210
1736,5634.0,5635,1,5425,210
1737,5636.3,5638,2,5428,210
1738,5638.9,5641,2,5431,210
1739,5641.4,5644,3,5434,210
1740,5656.846153846154,5647,12790,5437,210
1741,5651.9,5651,12799,5440,211
1742,5658.4,5654,12796,5443,211
1743,5661.0,5657,12796,5446,211
1744,5663.8,5660,12796,5450,210
1745,5666.5,5663,12796,5453,210
1746,5669.6,5666,12796,5456,210
1747,5672.3,5670,12798,5459,211
1748,5675.7,5673,12797,5462,211
1749,5680.2,5676,12796,5465,211
1750,5684.4,5679,12795,5468,211
1751,5687.6,5682,12794,5471,211
1752,5690.1,5686,12796,5475,211
1753,5693.6,5689,12795,5478,211
1754,5696.0,5692,12796,5481,211
1755,5698.2,5695,12797,5484,211
1756,5700.5,5698,12798,5487,211
1757,5702.7,5701,12798,5490,211
1758,5705.3,5704,12799,5493,211
1759,5707.9,5707,12799,5496,211
1760,5710.8,5711,0,5500,211
1761,5716.2,5714,12798,5503,211
1762,5721.6,5717,12795,5506,211
1763,5724.5,5720,12796,5509,211
1764,5727.6,5723,12795,5512,211
1765,5730.9,5726,12795,5515,211
1766,5733.3,5730,12797,5518,212
1767,5735.9,5733,12797,5521,212
1768,5738.8,5736,12797,5525,211
1769,5743.0,5739,12796,5528,211
1770,5748.1,5742,12794,5531,211
1771,5752.6,5745,12792,5534,211
1772,5755.4,5748,12793,5537,211
1773,5757.7,5751,12793,5540,211
1774,5760.2,5754,12794,5543,211
1775,5762.6,5758,12795,5546,212
1776,5764.7,5761,12796,5550,211
1777,5767.0,5764,12797,5553,211
1778,5769.4,5767,12798,5556,211
1779,5771.9,5770,12798,5559,211
1780,5784.833333333333,5773,12788,5562,211
1781,5783.1,5776,12793,5565,211
1782,5789.6,5779,12789,5568,211
1783,5792.3,5782,12790,5571,211
1784,5795.4,5786,12791,5575,211
1785,5797.6,5789,12791,5578,211
1786,5799.6,5792,12792,5581,211
1787,5802.0,5795,12793,5584,211
1788,5804.5,5798,12794,5587,211
1789,5807.3,5801,12794,5590,211
1790,5810.8,5804,12793,5593,211
1791,5814.7,5808,12793,5596,212
1792,5817.6,5811,12793,5600,211
1793,5819.6,5814,12794,5603,211
1794,5821.6,5817,12795,5606,211
1795,5823.5,5820,12796,5609,211
1796,5825.2,5823,12798,5612,211
1797,5826.9,5826,12799,5615,211
1798,5828.9,5830,1,5618,212
1799,5830.8,5833,2,5621,212
1800,5832.9,5836,3,5625,211
1801,5848.7692307692305,5839,12790,5628,211
1802,5842.9,5842,12799,5631,211
1803,5845.5,5845,0,5634,211
1804,5848.1,5848,0,5637,211
1805,5851.1,5852,1,5640,212
1806,5854.0,5855,1,5643,212
1807,5856.0,5858,2,5646,212
1808,5858.0,5861,3,5650,211
1809,5860.9,5864,3,5653,211
1810,5864.8,5867,2,5656,211
1811,5869.2,5870,1,5659,211
1812,5874.5,5873,12798,5662,211
1813,5878.8,5876,12797,5665,211
1814,5881.5,5879,12798,5668,211
1815,5884.1,5882,12798,5671,211
1816,5886.5,5885,12798,5675,210
1817,5888.8,5888,12799,5678,210
1818,5890.7,5891,0,5681,210
1819,5892.5,5894,2,5684,210
1820,5894.6,5897,2,5687,210
1821,5896.9,5901,4,5690,211
1822,5904.6,5904,12799,5693,211
1823,5912.4,5907,12795,5696,211
1824,5914.8,5910,12795,5700,210
1825,5916.9,5913,12796,5703,210
1826,5919.4,5916,12797,5706,210
1827,5922.5,5919,12796,5709,210
1828,5924.6,5922,12797,5712,210
1829,5926.8,5925,12798,5715,210
1830,5929.8,5928,12798,5718,210
1831,5933.3,5931,12798,5721,210
1832,5936.8,5934,12797,5725,209
1833,5940.8,5937,12796,5728,209
1834,5934.166666666667,5940,6,5731,209
1835,5947.1,5943,12796,5734,209
1836,5949.7,5945,12795,5737,208
1837,5951.9,5948,12796,5740,208
1838,5953.9,5951,12797,5743,208
1839,5956.1,5954,12798,5746,208
1840,5958.2,5957,12799,5750,207
1841,5960.5,5960,0,5753,207
1842,5962.9,5963,0,5756,207
1843,5968.0,5966,12798,5759,207
1844,5973.2,5969,12796,5762,207
1845,5976.5,5972,12796,5765,207
1846,5979.3,5975,12796,5768,207
1847,5982.1,5978,12796,5771,207
1848,5979.75,5981,1,5775,206
1849,5987.7,5984,12796,5778,206
1850,5989.9,5987,12797,5781,206
1851,5992.4,5990,12798,5784,206
1852,5994.6,5993,12798,5787,206
1853,5992.818181818182,5996,3,5790,206
1854,6002.4,5999,12797,5793,206
1855,6002.909090909091,6002,12799,5796,206
1856,6011.4,6005,12794,5800,205
1857,6013.8,6008,12794,5803,205
1858,6016.1,6011,12795,5806,205
1859,6018.2,6014,12796,5809,205
1860,6020.3,6017,12797,5812,205
1861,6022.4,6020,12798,5815,205
1862,6024.6,6023,12798,5818,205
1863,6026.7,6026,12799,5821,205
1864,6046.4,6029,12783,5825,204
1865,6038.2,6032,12794,5828,204
1866,6044.6,6035,12790,5831,204
1867,6047.1,6038,12791,5834,204
1868,6049.2,6041,12792,5837,204
1869,6052.0,6044,12792,5840,204
1870,6054.7,6047,12792,5843,204
1871,6057.1,6050,12793,5846,204
1872,6059.0,6053,12794,5850,203
1873,6060.9,6056,12795,5853,203
1874,6063.5,6059,12796,5856,203
1875,6066.3,6062,12796,5859,203
1876,6069.2,6065,12796,5862,203
1877,6068.272727272727,6067,12799,5865,202
1878,6075.8,6070,12794,5868,202
1879,6077.5,6073,12796,5871,202
1880,6079.1,6076,12797,5875,201
1881,6080.9,6079,12798,5878,201
1882,6082.4,6082,0,5881,201
1883,6084.3,6085,1,5884,201
1884,6091.444444444444,6088,12797,5887,201
1885,6088.1,6091,3,5890,201
1886,6108.2,6094,12786,5893,201
1887,6097.1,6097,0,5896,201
1888,6100.2,6100,0,5900,200
1889,6102.6,6103,0,5903,200
1890,6104.8,6106,1,5906,200
1891,6107.7,6109,1,5909,200
1892,6110.3,6112,2,5912,200
1893,6112.5,6115,2,5915,200
1894,6115.2,6118,3,5918,200
1895,6117.6,6121,3,5921,200
1896,6120.7,6124,3,5925,199
1897,6120.454545454545,6127,7,5928,199
1898,6128.2,6130,2,5931,199
1899,6121.307692307692,6133,12,5934,199
1900,6137.4,6135,12798,5937,198
1901,6139.9,6138,12798,5940,198
1902,6142.5,6141,12798,5943,198
1903,6144.2,6144,0,5946,198
1904,6146.0,6147,1,5950,197
1905,6147.9,6150,2,5953,197
1906,6149.8,6153,3,5956,197
1907,6152.2,6156,4,5959,197
1908,6159.6,6159,12799,5962,197
1909,6166.8,6162,12795,5965,197
1910,6169.5,6164,12794,5968,196
1911,6171.9,6167,12795,5971,196
1912,6173.8,6170,12796,5975,195
1913,6176.6,6173,12796,5978,195
1914,6179.2,6176,12797,5981,195
1915,6181.6,6179,12797,5984,195
1916,6183.8,6182,12798,5987,195
1917,6186.1,6185,12799,5990,195
1918,6188.9,6187,12798,5993,194
1919,6187.181818181818,6190,3,5996,194
1920,6195.9,6193,12797,6000,193
1921,6200.4,6196,12796,6003,193
1922,6203.5,6199,12796,6006,193
1923,6205.7,6202,12796,6009,193
1924,6207.7,6205,12797,6012,193
1925,6209.5,6207,12798,6015,192
1926,6211.3,6210,12799,6018,192
1927,6213.2,6213,0,6021,192
1928,6215.4,6216,1,6025,191
1929,6217.9,6219,1,6028,191
1930,6235.846153846154,6222,12786,6031,191
1931,6228.2,6224,12796,6034,190
1932,6231.1,6227,12796,6037,190
1933,6233.5,6230,12796,6040,190
1934,6235.9,6233,12797,6043,190
1935,6239.6,6236,12796,6046,190
1936,6242.8,6239,12796,6050,189
1937,6244.9,6241,12796,6053,188
1938,6246.4,6244,12798,6056,188
1939,6248.4,6247,12799,6059,188
1940,6250.2,6250,0,6062,188
1941,6253.5,6253,0,6065,188
1942,6258.0,6256,12798,6068,188
1943,6262.8,6259,12796,6071,188
1944,6252.615384615385,6261,8,6075,186
1945,6269.7,6264,12794,6078,186
1946,6271.8,6267,12795,6081,186
1947,6273.9,6270,12796,6084,186
1948,6275.5,6273,12798,6087,186
1949,6277.7,6276,12798,6090,186
1950,6280.1,6279,12799,6093,186
1951,6282.6,6282,12799,6096,186
1952,6310.0,6284,12774,6100,184
1953,6294.4,6287,12793,6103,184
1954,6299.3,6290,12791,6106,184
1955,6301.5,6293,12792,6109,184
1956,6304.0,6296,12792,6112,184
1957,6307.2,6299,12792,6115,184
1958,6309.9,6302,12792,6118,184
1959,6311.7,6305,12793,6121,184
1960,6313.5,6308,12794,6125,183
1961,6315.0,6310,12795,6128,182
1962,6317.2,6313,12796,6131,182
1963,6320.2,6316,12796,6134,182
1964,6323.3,6319,12796,6137,182
1965,6316.916666666667,6322,5,6140,182
1966,6324.454545454545,6325,1,6143,182
1967,6331.6,6328,12796,6146,182
1968,6333.7,6331,12797,6150,181
1969,6335.0,6333,12798,6153,180
1970,6336.8,6336,12799,6156,180
1971,6338.2,6339,1,6159,180
1972,6340.3,6342,2,6162,180
1973,6342.3,6345,3,6165,180
1974,6344.3,6348,4,6168,180
1975,6348.7,6351,2,6171,180
1976,6353.6,6355,1,6175,180
1977,6356.1,6358,2,6178,180
1978,6358.3,6361,3,6181,180
1979,6360.4,6364,4,6184,180
1980,6363.5,6367,4,6187,180
1981,6366.2,6370,4,6190,180
1982,6368.0,6373,5,6193,180
1983,6369.9,6377,7,6196,181
1984,6372.4,6378,6,6200,178
1985,6375.0,6381,6,6203,178
1986,6378.7,6383,4,6206,177
1987,6382.7,6386,3,6209,177
1988,6387.1,6388,1,6212,176
1989,6391.4,6391,0,6215,176
1990,6394.8,6394,12799,6218,176
1991,6397.0,6396,12799,6221,175
1992,6399.1,6398,12799,6225,173
1993,6401.2,6401,0,6228,173
1994,6403.0,6404,1,6231,173
1995,6404.8,6406,1,6234,172
1996,6406.7,6409,2,6237,172
1997,6409.3,6412,3,6240,172
1998,6416.5,6414,12798,6243,171
1999,6423.7,6417,12793,6246,171
2000,6426.1,6420,12794,6250,170
2001,6428.2,6423,12795,6253,170
2002,6431.1,6426,12795,6256,170
2003,6433.5,6429,12796,6259,170
2004,6435.5,6431,12796,6262,169
2005,6437.7,6434,12796,6265,169
2006,6440.2,6437,12797,6268,169
2007,6442.6,6440,12797,6271,169
2008,6445.5,6443,12798,6275,168
2009,6448.6,6446,12797,6278,168
2010,6451.4,6448,12797,6281,167
2011,6455.3,6451,12796,6284,167
2012,6458.9,6454,12795,6287,167
2013,6461.7,6457,12795,6290,167
2014,6463.8,6460,12796,6293,167
2015,6465.3,6462,12797,6296,166
2016,6467.2,6465,12798,6300,165
2017,6469.3,6468,12799,6303,165
2018,6471.0,6471,0,6306,165
2019,6473.2,6473,0,6309,164
2020,6496.875,6476,12779,6312,164
2021,6482.5,6479,12796,6315,164
2022,6486.6,6482,12795,6318,164
2023,6489.0,6485,12796,6321,164
2024,6491.1,6487,12796,6325,162
2025,6494.5,6490,12796,6328,162
2026,6498.1,6493,12795,6331,162
2027,6499.9,6496,12796,6334,162
2028,6501.9,6499,12797,6337,162
2029,6503.7,6501,12797,6340,161
2030,6505.3,6504,12799,6343,161
2031,6508.4,6507,12799,6346,161
2032,6511.7,6510,12798,6350,160
2033,6516.3,6513,12797,6353,160
2034,6521.8,6516,12794,6356,160
2035,6524.9,6519,12794,6359,160
2036,6527.0,6521,12794,6362,159
2037,6573.0,6524,12751,6365,159
2038,6574.0,6527,12753,6368,159
2039,6576.0,6530,12754,6371,159
2040,6577.6,6533,12755,6375,158
2041,6579.6,6536,12756,6378,158
2042,6539.7,6539,12799,6381,158
2043,6593.3,6542,12749,6384,158
2044,6604.8,6544,12739,6387,157
2045,6608.6,6547,12738,6390,157
2046,6610.8,6550,12739,6393,157
2047,None,6553,0,6396,157
2048,6512.6,6556,43,6400,156
2049,6515.6,6559,43,6403,156
2050,6518.0,6562,44,6406,156
2051,6520.2,6564,44,6409,155
2052,6522.0,6567,45,6412,155
2053,6573.4,6570,12797,6415,155
2054,6526.8,6573,46,6418,155
2055,6530.2,6576,46,6421,155
2056,6534.142857142857,6579,45,6425,154
2057,6540.0,6582,42,6428,154
2058,6543.2,6584,41,6431,153
2059,6589.9,6587,12797,6434,153
2060,6591.3,6590,12799,6437,153
2061,6593.0,6593,0,6440,153
2062,6594.7,6596,1,6443,153
2063,6596.4,6599,3,6446,153
2064,6598.3,6602,4,6450,152
2065,6600.1,6604,4,6453,151
2066,6604.7,6607,2,6456,151
2067,6609.6,6610,0,6459,151
2068,6612.2,6613,1,6462,151
2069,6614.3,6616,2,6465,151
2070,6617.2,6619,2,6468,151
2071,6620.3,6621,1,6471,150
2072,6622.4,6624,2,6475,149
2073,6624.5,6627,2,6478,149
2074,6626.4,6630,4,6481,149
2075,6628.6,6633,4,6484,149
2076,6631.0,6636,5,6487,149
2077,6627.0,6639,12,6490,149
2078,6638.4,6642,4,6493,149
2079,6643.0,6644,1,6496,148
2080,6643.272727272727,6647,4,6500,147
2081,6651.2,6650,12799,6503,147
2082,6653.2,6653,0,6506,147
2083,6654.9,6656,1,6509,147
2084,6656.9,6659,2,6512,147
2085,6658.9,6661,2,6515,146
2086,6660.9,6664,3,6518,146
2087,6662.6,6667,4,6521,146
2088,6664.9,6670,5,6525,145
2089,6679.75,6673,12793,6528,145
2090,6678.7,6676,12797,6531,145
2091,6681.9,6678,12796,6534,144
2092,6684.7,6681,12796,6537,144
2093,6684.0,6684,0,6540,144
2094,6689.5,6687,12798,6543,144
2095,6691.5,6690,12798,6546,144
2096,6693.5,6693,0,6550,143
2097,6695.6,6695,12799,6553,142
2098,6697.9,6698,0,6556,142
2099,6701.0,6701,0,6559,142
2100,6704.7,6704,12799,6562,142
2101,6703.545454545455,6707,3,6565,142
2102,6712.1,6709,12797,6568,141
2103,6715.0,6712,12797,6571,141
2104,6717.5,6714,12796,6575,139
2105,6719.5,6716,12796,6578,138
2106,6721.8,6719,12797,6581,138
2107,6723.6,6722,12798,6584,138
2108,6725.5,6724,12798,6587,137
2109,6727.6,6727,12799,6590,137
2110,6729.8,6729,12799,6593,136
2111,6732.0,6731,12799,6596,135
2112,6736.8,6733,12796,6600,133
2113,6742.6,6736,12793,6603,133
2114,6745.8,6739,12793,6606,133
2115,6749.0,6742,12793,6609,133
2116,6752.2,6746,12794,6612,134
2117,6754.4,6749,12795,6615,134
2118,6756.1,6752,12796,6618,134
2119,6757.8,6755,12797,6621,134
2120,6760.3,6758,12798,6625,133
2121,6763.2,6761,12798,6628,133
2122,6766.4,6764,12798,6631,133
2123,6769.2,6768,12799,6634,134
2124,6773.6,6771,12797,6637,134
2125,6773.454545454545,6773,0,6640,133
2126,6781.8,6776,12794,6643,133
2127,6783.9,6779,12795,6646,133
2128,6785.7,6782,12796,6650,132
2129,6787.8,6785,12797,6653,132
2130,6789.7,6788,12798,6656,132
2131,6791.5,6791,0,6659,132
2132,6793.4,6794,1,6662,132
2133,6795.6,6796,0,6665,131
2134,6798.6,6799,0,6668,131
2135,6806.3,6802,12796,6671,131
2136,6813.3,6805,12792,6675,130
2137,6816.1,6808,12792,6678,130
2138,6818.8,6811,12792,6681,130
2139,6821.1,6814,12793,6684,130
2140,6822.9,6817,12794,6687,130
2141,6824.7,6819,12794,6690,129
2142,6826.9,6822,12795,6693,129
2143,6828.6,6825,12796,6696,129
2144,6826.727272727273,6828,1,6700,128
2145,6834.8,6831,12796,6703,128
2146,6837.7,6834,12796,6706,128
2147,6836.272727272727,6837,1,6709,128
2148,6844.0,6840,12796,6712,128
2149,6845.5,6843,12798,6715,128
2150,6847.3,6846,12799,6718,128
2151,6848.7,6848,12799,6721,127
2152,6850.3,6851,1,6725,126
2153,6851.8,6854,2,6728,126
2154,6853.4,6857,4,6731,126
2155,6855.2,6860,5,6734,126
2156,6857.7,6863,5,6737,126
2157,6862.4,6866,4,6740,126
2158,6867.3,6869,2,6743,126
2159,6870.6,6871,0,6746,125
2160,6871.909090909091,6874,2,6750,124
2161,6875.9,6877,1,6753,124
2162,6877.9,6880,2,6756,124
2163,6880.1,6883,3,6759,124
2164,6882.2,6886,4,6762,124
2165,6884.4,6889,5,6765,124
2166,6887.7,6892,4,6768,124
2167,6891.3,6895,4,6771,124
2168,6885.153846153846,6898,13,6775,123
2169,6900.9,6901,0,6778,123
2170,6904.4,6903,12799,6781,122
2171,6907.1,6906,12799,6784,122
2172,6909.4,6909,0,6787,122
2173,6911.2,6912,1,6790,122
2174,6913.2,6915,2,6793,122
2175,6915.0,6918,3,6796,122
2176,6917.0,6921,4,6800,121
2177,6918.9,6924,5,6803,121
2178,6921.4,6927,6,6806,121
2179,6928.363636363636,6930,2,6809,121
2180,6931.4,6932,1,6812,120
2181,6938.8,6935,12796,6815,120
2182,6941.6,6938,12796,6818,120
2183,6943.8,6941,12797,6821,120
2184,6946.1,6944,12798,6825,119
2185,6948.2,6947,12799,6828,119
2186,6950.4,6950,0,6831,119
2187,6952.5,6953,0,6834,119
2188,6955.5,6955,0,6837,118
2189,6959.1,6958,12799,6840,118
2190,6963.2,6961,12798,6843,118
2191,6967.1,6964,12797,6846,118
2192,6970.2,6967,12797,6850,117
2193,6972.7,6970,12797,6853,117
2194,6975.1,6973,12798,6856,117
2195,6977.2,6976,12799,6859,117
2196,6979.2,6979,0,6862,117
2197,6981.5,6981,0,6865,116
2198,6983.7,6984,0,6868,116
2199,6985.7,6987,1,6871,116
2200,6987.9,6990,2,6875,115
2201,6990.3,6993,3,6878,115
2202,6995.3,6996,1,6881,115
2203,7002.0,6999,12797,6884,115
2204,7006.2,7002,12796,6887,115
2205,7008.7,7004,12795,6890,114
2206,7010.6,7007,12796,6893,114
2207,7012.7,7010,12797,6896,114
2208,7014.7,7013,12798,6900,113
2209,7017.6,7016,12798,6903,113
2210,7015.333333333333,7019,4,6906,113
2211,7023.4,7022,12799,6909,113
2212,7028.0,7025,12797,6912,113
2213,7032.3,7028,12796,6915,113
2214,7035.7,7031,12795,6918,113
2215,7038.6,7034,12795,6921,113
2216,7040.5,7037,12796,6925,112
2217,7042.2,7040,12798,6928,112
2218,7044.5,7043,12798,6931,112
2219,7046.8,7046,12799,6934,112
2220,7049.2,7049,0,6937,112
2221,7051.6,7052,0,6940,112
2222,7053.7,7055,1,6943,112
2223,7056.3,7058,2,6946,112
2224,7063.6,7061,12797,6950,111
2225,7068.636363636364,7064,12795,6953,111
2226,7074.6,7067,12792,6956,111
2227,7076.8,7070,12793,6959,111
2228,7079.2,7073,12794,6962,111
2229,7080.8,7076,12795,6965,111
2230,7082.7,7079,12796,6968,111
2231,7085.2,7082,12797,6971,111
2232,7087.5,7085,12798,6975,110
2233,7091.2,7088,12797,6978,110
2234,7095.6,7091,12795,6981,110
2235,7098.3,7094,12796,6984,110
2236,7100.1,7097,12797,6987,110
2237,7101.8,7100,12798,6990,110
2238,7103.6,7103,12799,6993,110
2239,7105.2,7106,1,6996,110
2240,7107.0,7109,2,7000,109
2241,7108.8,7112,3,7003,109
2242,7110.4,7115,5,7006,109
2243,7112.1,7118,6,7009,109
2244,7114.5,7121,6,7012,109
2245,7126.166666666667,7124,12798,7015,109
2246,7122.181818181818,7127,5,7018,109
2247,7129.7,7130,0,7021,109
2248,7131.9,7133,1,7025,108
2249,7133.8,7136,2,7028,108
2250,7135.7,7139,3,7031,108
2251,7137.8,7142,4,7034,108
2252,7140.6,7145,4,7037,108
2253,7143.9,7148,4,7040,108
2254,7137.615384615385,7151,13,7043,108
2255,7154.4,7154,0,7046,108
2256,7158.2,7157,12799,7050,107
2257,7160.5,7160,0,7053,107
2258,7162.8,7163,0,7056,107
2259,7165.2,7166,1,7059,107
2260,7167.4,7169,2,7062,107
2261,7169.5,7172,2,7065,107
2262,7171.9,7175,3,7068,107
2263,7174.0,7178,4,7071,107
2264,7176.0,7181,5,7075,106
2265,7178.1,7184,6,7078,106
2266,7181.0,7188,7,7081,107
2267,7184.5,7191,6,7084,107
2268,7196.6,7194,12797,7087,107
2269,7199.5,7197,12798,7090,107
2270,7201.7,7200,12798,7093,107
2271,7203.7,7203,12799,7096,107
2272,7205.9,7206,0,7100,106
2273,7209.0,7209,0,7103,106
2274,7212.3,7212,0,7106,106
2275,7216.5,7215,12798,7109,106
2276,7220.9,7218,12797,7112,106
2277,7224.0,7221,12797,7115,106
2278,7226.5,7224,12798,7118,106
2279,7229.0,7227,12798,7121,106
2280,7231.5,7230,12798,7125,105
2281,7233.8,7233,12799,7128,105
2282,7235.9,7236,0,7131,105
2283,7238.4,7239,1,7134,105
2284,7240.7,7242,1,7137,105
2285,7243.1,7245,2,7140,105
2286,7245.3,7248,3,7143,105
2287,7248.9,7251,2,7146,105
2288,7260.272727272727,7254,12794,7150,104
2289,7261.6,7257,12795,7153,104
2290,7264.5,7261,12796,7156,105
2291,7266.7,7264,12797,7159,105
2292,7268.7,7267,12798,7162,105
2293,7271.1,7270,12799,7165,105
2294,7262.0,7273,11,7168,105
2295,7278.2,7276,12798,7171,105
2296,7282.4,7279,12797,7175,104
2297,7286.9,7282,12795,7178,104
2298,7290.5,7285,12794,7181,104
2299,7293.0,7288,12795,7184,104
2300,7295.7,7291,12795,7187,104
2301,7297.8,7294,12796,7190,104
2302,7299.9,7297,12797,7193,104
2303,7301.8,7301,12799,7196,105
2304,7304.5,7304,0,7200,104
2305,7307.3,7307,0,7203,104
2306,7309.3,7310,1,7206,104
2307,7311.6,7313,1,7209,104
2308,7313.545454545455,7316,2,7212,104
2309,7323.0,7320,12797,7215,105
2310,7330.2,7323,12793,7218,105
2311,7332.8,7326,12793,7221,105
2312,7335.2,7329,12794,7225,104
2313,7337.2,7332,12795,7228,104
2314,7339.8,7335,12795,7231,104
2315,7342.6,7339,12796,7234,105
2316,7337.583333333333,7342,4,7237,105
2317,7344.545454545455,7345,0,7240,105
2318,7352.6,7348,12795,7243,105
2319,7355.3,7352,12797,7246,106
2320,7357.3,7355,12798,7250,105
2321,7358.9,7358,12799,7253,105
2322,7360.4,7361,1,7256,105
2323,7362.3,7364,2,7259,105
2324,7364.2,7367,3,7262,105
2325,7366.4,7370,4,7265,105
2326,7368.4,7374,6,7268,106
2327,7370.9,7377,6,7271,106
2328,7370.071428571428,7380,10,7275,105
2329,7383.818181818182,7383,12799,7278,105
2330,7385.0,7387,2,7281,106
2331,7388.0,7390,2,7284,106
2332,7390.5,7393,2,7287,106
2333,7392.7,7396,3,7290,106
2334,7395.7,7400,4,7293,107
2335,7399.6,7403,3,7296,107
2336,7403.0,7406,3,7300,106
2337,7403.727272727273,7409,5,7303,106
2338,7412.3,7412,0,7306,106
2339,7415.2,7415,0,7309,106
2340,7417.5,7419,2,7312,107
2341,7420.1,7422,2,7315,107
2342,7422.6,7425,2,7318,107
2343,7424.9,7428,3,7321,107
2344,7427.0,7431,4,7325,106
2345,7429.7,7434,4,7328,106
2346,7431.9,7438,6,7331,107
2347,7435.2,7441,6,7334,107
2348,7437.8,7444,6,7337,107
2349,7447.75,7447,12799,7340,107
2350,7448.5,7450,2,7343,107
2351,7455.3,7454,12799,7346,108
2352,7458.0,7457,12799,7350,107
2353,7461.1,7460,12799,7353,107
2354,7464.2,7463,12799,7356,107
2355,7467.6,7466,12798,7359,107
2356,7471.6,7470,12798,7362,108
2357,7470.727272727273,7473,2,7365,108
2358,7478.6,7476,12797,7368,108
2359,7481.4,7479,12798,7371,108
2360,7484.5,7483,12798,7375,108
2361,7487.2,7486,12799,7378,108
2362,7489.9,7489,12799,7381,108
2363,7492.5,7492,0,7384,108
2364,7494.9,7495,0,7387,108
2365,7497.2,7499,2,7390,109
2366,7500.1,7502,2,7393,109
2367,7502.363636363636,7505,3,7396,109
2368,7507.5,7508,0,7400,108
2369,7530.235294117647,7512,12782,7403,109
2370,7517.0,7515,12798,7406,109
2371,7520.8,7518,12797,7409,109
2372,7523.7,7521,12797,7412,109
2373,7527.1,7525,12798,7415,110
2374,7530.2,7528,12798,7418,110
2375,7534.3,7531,12797,7421,110
2376,7531.0,7535,4,7425,110
2377,7543.9,7538,12794,7428,110
2378,7546.3,7541,12795,7431,110
2379,7548.6,7544,12795,7434,110
2380,7550.9,7547,12796,7437,110
2381,7553.7,7551,12797,7440,111
2382,7556.3,7554,12798,7443,111
2383,7558.9,7557,12798,7446,111
2384,7561.1,7561,0,7450,111
2385,7563.6,7564,0,7453,111
2386,7566.6,7567,0,7456,111
2387,7569.5,7571,2,7459,112
2388,7572.2,7574,2,7462,112
2389,7579.9,7577,12797,7465,112
2390,7587.5,7581,12794,7468,113
2391,7590.1,7584,12794,7471,113
2392,7592.4,7588,12796,7475,113
2393,7588.583333333333,7591,2,7478,113
2394,7598.5,7594,12796,7481,113
2395,7602.6,7598,12795,7484,114
2396,7606.0,7601,12795,7487,114
2397,7608.4,7604,12796,7490,114
2398,7611.0,7608,12797,7493,115
2399,7613.0,7611,12798,7496,115
2400,7615.0,7614,12799,7500,114
2401,7616.7,7618,1,7503,115
2402,7618.7,7621,2,7506,115
2403,7621.0,7625,4,7509,116
2404,7623.2,7628,5,7512,116
2405,7626.3,7631,5,7515,116
2406,7629.4,7635,6,7518,117
2407,7631.8,7638,6,7521,117
2408,7645.307692307692,7641,12796,7525,116
2409,7641.3,7645,4,7528,117
2410,7645.3,7648,3,7531,117
2411,7648.7,7652,3,7534,118
2412,7648.909090909091,7655,6,7537,118
2413,7655.4,7658,3,7540,118
2414,7660.2,7662,2,7543,119
2415,7657.083333333333,7665,8,7546,119
2416,7667.9,7668,0,7550,118
2417,7670.5,7672,2,7553,119
2418,7673.6,7675,1,7556,119
2419,7676.2,7678,2,7559,119
2420,7679.0,7682,3,7562,120
2421,7681.7,7685,3,7565,120
2422,7684.1,7688,4,7568,120
2423,7686.6,7692,5,7571,121
2424,7688.545454545455,7695,6,7575,120
2425,7692.9,7699,6,7578,121
2426,7695.1,7702,7,7581,121
2427,7709.0,7705,12796,7584,121
2428,7706.1,7709,3,7587,122
2429,7712.9,7712,12799,7590,122
2430,7716.3,7715,12799,7593,122
2431,7720.8,7719,12798,7596,123
2432,7724.9,7722,12797,7600,122
2433,7728.3,7726,12798,7603,123
2434,7731.7,7729,12797,7606,123
2435,7734.6,7732,12797,7609,123
2436,7737.3,7735,12798,7612,123
2437,7740.1,7739,12799,7615,124
2438,7743.5,7742,12798,7618,124
2439,7746.6,7745,12798,7621,124
2440,7749.4,7749,0,7625,124
2441,7751.8,7752,0,7628,124
2442,7754.5,7756,2,7631,125
2443,7758.4,7759,1,7634,125
2444,7762.3,7762,0,7637,125
2445,7765.3,7766,1,7640,126
2446,7785.5,7769,12784,7643,126
2447,7775.3,7773,12798,7646,127
2448,7779.1,7776,12797,7650,126
2449,7782.7,7780,12797,7653,127
2450,7787.6,7783,12795,7656,127
2451,7792.5,7786,12794,7659,127
2452,7791.545454545455,7790,12798,7662,128
2453,7800.6,7793,12792,7665,128
2454,7803.0,7797,12794,7668,129
2455,7805.1,7800,12795,7671,129
2456,7807.3,7803,12796,7675,128
2457,7810.0,7807,12797,7678,129
2458,7812.6,7810,12797,7681,129
2459,7815.2,7814,12799,7684,130
2460,7818.1,7817,12799,7687,130
2461,7821.3,7821,0,7690,131
2462,7824.4,7824,0,7693,131
2463,7826.8,7827,0,7696,131
2464,7829.5,7831,2,7700,131
2465,7843.083333333333,7834,12791,7703,131
2466,7843.8,7838,12794,7706,132
2467,7847.7,7841,12793,7709,132
2468,7851.1,7845,12794,7712,133
2469,7854.0,7848,12794,7715,133
2470,7857.7,7852,12794,7718,134
2471,7857.0,7855,12798,7721,134
2472,7863.8,7859,12795,7725,134
2473,7866.8,7862,12795,7728,134
2474,7869.3,7866,12797,7731,135
2475,7871.3,7869,12798,7734,135
2476,7873.1,7873,0,7737,136
2477,7875.0,7876,1,7740,136
2478,7876.9,7880,3,7743,137
2479,7879.9,7883,3,7746,137
2480,7883.3,7887,4,7750,137
2481,7886.1,7890,4,7753,137
2482,7888.3,7894,6,7756,138
2483,7895.545454545455,7897,1,7759,138
2484,7897.2,7901,4,7762,139
2485,7901.6,7904,2,7765,139
2486,7905.4,7908,3,7768,140
2487,7909.9,7911,1,7771,140
2488,7915.0,7915,0,7775,140
2489,7907.384615384615,7918,11,7778,140
2490,7922.9,7922,12799,7781,141
2491,7925.7,7925,12799,7784,141
2492,7928.2,7929,1,7787,142
2493,7930.7,7932,1,7790,142
2494,7934.0,7936,2,7793,143
2495,7937.2,7939,2,7796,143
2496,7939.9,7943,3,7800,143
2497,7942.4,7946,4,7803,143
2498,7944.181818181818,7950,6,7806,144
2499,7947.9,7953,5,7809,144
2500,7950.5,7957,6,7812,145
2501,7953.0,7960,7,7815,145
2502,7961.2,7964,3,7818,146
2503,7968.9,7967,12798,7821,146
2504,7972.4,7970,12798,7825,145
2505,7976.3,7974,12798,7828,146
2506,7980.1,7977,12797,7831,146
2507,7984.2,7981,12797,7834,147
2508,7988.2,7984,12796,7837,147
2509,7991.6,7988,12796,7840,148
2510,7994.4,7991,12797,7843,148
2511,7997.2,7995,12798,7846,149
2512,7999.9,7998,12798,7850,148
2513,8002.9,8002,12799,7853,149
2514,8006.1,8005,12799,7856,149
2515,8009.4,8009,0,7859,150
2516,8009.571428571428,8012,2,7862,150
2517,8016.8,8016,12799,7865,151
2518,8019.5,8019,0,7868,151
2519,8022.2,8023,1,7871,152
2520,8027.4,8026,12799,7875,151
2521,8033.3,8030,12797,7878,152
2522,8037.8,8033,12795,7881,152
2523,8041.8,8037,12795,7884,153
2524,8045.6,8040,12794,7887,153
2525,8035.714285714285,8044,8,7890,154
2526,8055.2,8047,12792,7893,154
2527,8057.8,8051,12793,7896,155
2528,8060.2,8054,12794,7900,154
2529,8063.2,8058,12795,7903,155
2530,8065.9,8061,12795,7906,155
2531,8068.6,8065,12796,7909,156
2532,8071.0,8068,12797,7912,156
2533,8073.6,8072,12798,7915,157
2534,8077.0,8075,12798,7918,157
2535,8080.2,8079,12799,7921,158
2536,8082.9,8082,12799,7925,157
2537,8085.3,8085,0,7928,157
2538,8092.7,8089,12796,7931,158
2539,8100.1,8092,12792,7934,158
2540,8103.5,8096,12792,7937,159
2541,8106.4,8100,12794,7940,160
2542,8109.8,8103,12793,7943,160
2543,8113.3,8107,12794,7946,161
2544,8116.8,8110,12793,7950,160
2545,8120.0,8114,12794,7953,161
2546,8123.0,8117,12794,7956,161
2547,8125.3,8121,12796,7959,162
2548,8127.2,8124,12797,7962,162
2549,8129.0,8128,12799,7965,163
2550,8131.0,8132,1,7968,164
2551,8133.4,8135,2,7971,164
2552,8136.8,8139,2,7975,164
2553,8139.8,8142,2,7978,164
2554,8142.3,8146,4,7981,165
2555,8144.8,8150,5,7984,166
2556,8159.307692307692,8153,12794,7987,166
2557,8155.2,8157,2,7990,167
2558,8158.4,8160,2,7993,167
2559,8161.8,8164,2,7996,168
2560,8166.5,8167,0,8000,167
2561,8170.9,8171,0,8003,168
2562,8175.3,8174,12799,8006,168
2563,8179.2,8178,12799,8009,169
2564,8182.1,8181,12799,8012,169
2565,8185.3,8185,0,8015,170
2566,8187.9,8188,0,8018,170
2567,8190.6,8192,1,8021,171
2568,8193.3,8195,2,8025,170
2569,8196.0,8199,3,8028,171
2570,8199.1,8202,3,8031,171
2571,8202.1,8206,4,8034,172
2572,8205.1,8209,4,8037,172
2573,8207.6,8213,5,8040,173
2574,8237.681818181818,8216,12778,8043,173
2575,8222.3,8220,12798,8046,174
2576,8225.7,8223,12797,8050,173
2577,8229.1,8227,12798,8053,174
2578,8232.5,8230,12798,8056,174
2579,8228.166666666666,8234,6,8059,175
2580,8241.4,8237,12796,8062,175
2581,8245.1,8241,12796,8065,176
2582,8248.4,8244,12796,8068,176
2583,8251.2,8248,12797,8071,177
2584,8253.9,8251,12797,8075,176
2585,8257.0,8255,12798,8078,177
2586,8260.2,8258,12798,8081,177
2587,8263.3,8262,12799,8084,178
2588,8266.9,8265,12798,8087,178
2589,8270.5,8269,12798,8090,179
2590,8273.3,8272,12799,8093,179
2591,8276.0,8276,0,8096,180
2592,8279.2,8279,0,8100,179
2593,8285.3,8283,12798,8103,180
2594,8290.6,8286,12795,8106,180
2595,8294.4,8290,12796,8109,181
2596,8298.1,8293,12795,8112,181
2597,8301.5,8297,12796,8115,182
2598,8306.1,8300,12794,8118,182
2599,8294.642857142857,8304,9,8121,183
2600,8314.2,8307,12793,8125,182
2601,8316.9,8311,12794,8128,183
2602,8319.6,8314,12794,8131,183
2603,8322.3,8318,12796,8134,184
2604,8324.9,8321,12796,8137,184
2605,8327.5,8325,12798,8140,185
2606,8330.9,8328,12797,8143,185
2607,8334.0,8332,12798,8146,186
2608,8336.7,8335,12798,8150,185
2609,8339.6,8339,12799,8153,186
2610,8353.75,8342,12788,8156,186
2611,8354.4,8346,12792,8159,187
2612,8357.2,8349,12792,8162,187
2613,8359.9,8353,12793,8165,188
2614,8356.833333333334,8356,12799,8168,188
2615,8367.0,8360,12793,8171,189
2616,8370.4,8363,12793,8175,188
2617,8374.0,8367,12793,8178,189
2618,8377.2,8370,12793,8181,189
2619,8379.6,8374,12794,8184,190
2620,8381.5,8377,12796,8187,190
2621,8383.4,8381,12798,8190,191
2622,8385.6,8384,12798,8193,191
2623,8387.9,8388,0,8196,192
2624,8389.8,8391,1,8200,191
2625,8392.9,8395,2,8203,192
2626,8396.1,8398,2,8206,192
2627,8398.4,8402,4,8209,193
2628,8411.923076923076,8405,12793,8212,193
2629,8408.4,8409,1,8215,194
2630,8412.6,8412,12799,8218,194
2631,8415.1,8416,1,8221,195
2632,8418.3,8419,1,8225,194
2633,8421.8,8423,1,8228,195
2634,8425.7,8426,0,8231,195
2635,8417.92857142857,8430,12,8234,196
2636,8436.7,8433,12796,8237,196
2637,8439.4,8437,12798,8240,197
2638,8442.0,8440,12798,8243,197
2639,8444.6,8444,12799,8246,198
2640,8447.2,8447,0,8250,197
2641,8449.6,8450,0,8253,197
2642,8452.0,8454,2,8256,198
2643,8455.4,8457,2,8259,198
2644,8458.8,8461,2,8262,199
2645,8461.2,8464,3,8265,199
2646,8464.1,8468,4,8268,200
2647,8471.6,8471,12799,8271,200
2648,8479.0,8474,12795,8275,199
2649,8481.9,8478,12796,8278,200
2650,8485.0,8481,12796,8281,200
2651,8481.083333333334,8485,4,8284,201
2652,8492.0,8488,12796,8287,201
2653,8496.3,8492,12796,8290,202
2654,8500.4,8495,12795,8293,202
2655,8503.9,8498,12794,8296,202
2656,8507.5,8502,12794,8300,202
2657,8510.2,8505,12795,8303,202
2658,8513.0,8509,12796,8306,203
2659,8515.6,8512,12796,8309,203
2660,8518.0,8516,12798,8312,204
2661,8520.3,8519,12799,8315,204
2662,8523.7,8523,12799,8318,205
2663,8527.6,8526,12798,8321,205
2664,8530.9,8529,12798,8325,204
2665,8536.6,8533,12796,8328,205
2666,8542.1,8536,12794,8331,205
2667,8544.9,8540,12795,8334,206
2668,8547.4,8543,12796,8337,206
2669,8550.1,8546,12796,8340,206
2670,8553.8,8550,12796,8343,207
2671,8558.3,8553,12795,8346,207
2672,8563.0,8557,12794,8350,207
2673,8567.5,8560,12792,8353,207
2674,8571.0,8564,12793,8356,208
2675,8573.4,8567,12794,8359,208
2676,8576.2,8570,12794,8362,208
2677,8578.9,8574,12795,8365,209
2678,8581.4,8577,12796,8368,209
2679,8583.9,8580,12796,8371,209
2680,8586.3,8584,12798,8375,209
2681,8588.363636363636,8587,12799,8378,209
2682,8592.3,8591,12799,8381,210
2683,8599.818181818182,8594,12794,8384,210
2684,8603.8,8597,12793,8387,210
2685,8610.8,8601,12790,8390,211
2686,8613.5,8604,12790,8393,211
2687,8615.8,8607,12791,8396,211
2688,8618.0,8611,12793,8400,211
2689,8620.6,8614,12793,8403,211
2690,8624.0,8618,12794,8406,212
2691,8627.9,8621,12793,8409,212
2692,8631.7,8625,12793,8412,213
2693,8634.8,8628,12793,8415,213
2694,8637.1,8631,12794,8418,213
2695,8638.8,8635,12796,8421,214
2696,8640.8,8638,12797,8425,213
2697,8642.9,8642,12799,8428,214
2698,8644.8,8645,0,8431,214
2699,8646.6,8648,1,8434,214
2700,8647.818181818182,8652,4,8437,215
2701,8653.2,8655,2,8440,215
2702,8665.166666666666,8659,12794,8443,216
2703,8663.6,8662,12798,8446,216
2704,8666.6,8665,12798,8450,215
2705,8668.9,8669,0,8453,216
2706,8671.1,8672,1,8456,216
2707,8673.8,8676,2,8459,217
2708,8677.1,8679,2,8462,217
2709,8679.818181818182,8682,2,8465,217
2710,8684.8,8686,1,8468,218
2711,8689.2,8689,0,8471,218
2712,8687.818181818182,8693,5,8475,218
2713,8697.4,8696,12799,8478,218
2714,8700.6,8699,12798,8481,218
2715,8703.3,8702,12799,8484,218
2716,8705.4,8706,1,8487,219
2717,8707.5,8709,2,8490,219
2718,8710.0,8712,2,8493,219
2719,8712.8,8716,3,8496,220
2720,8715.8,8719,3,8500,219
2721,8736.714285714286,8722,12785,8503,219
2722,8731.3,8725,12794,8506,219
2723,8734.1,8729,12795,8509,220
2724,8736.6,8732,12795,8512,220
2725,8739.0,8735,12796,8515,220
2726,8741.7,8738,12796,8518,220
2727,8744.9,8742,12797,8521,221
2728,8748.6,8745,12796,8525,220
2729,8752.1,8748,12796,8528,220
2730,8756.3,8752,12796,8531,221
2731,8760.2,8755,12795,8534,221
2732,8763.2,8758,12795,8537,221
2733,8766.0,8761,12795,8540,221
2734,8769.0,8765,12796,8543,222
2735,8771.5,8768,12796,8546,222
2736,8773.7,8771,12797,8550,221
2737,8776.0,8774,12798,8553,221
2738,8779.3,8778,12799,8556,222
2739,8782.8,8781,12798,8559,222
2740,8785.4,8784,12799,8562,222
2741,8791.0,8788,12797,8565,223
2742,8797.3,8791,12794,8568,223
2743,8800.2,8794,12794,8571,223
2744,8802.5,8797,12794,8575,222
2745,8804.7,8801,12796,8578,223
2746,8807.0,8804,12797,8581,223
2747,8810.3,8807,12797,8584,223
2748,8813.7,8810,12796,8587,223
2749,8817.3,8813,12796,8590,223
2750,8822.0,8817,12795,8593,224
2751,8826.7,8820,12793,8596,224
2752,8830.4,8823,12793,8600,223
2753,8832.3,8826,12794,8603,223
2754,8834.6,8829,12794,8606,223
2755,8837.1,8833,12796,8609,224
2756,8839.5,8836,12796,8612,224
2757,8842.2,8839,12797,8615,224
2758,8844.9,8842,12797,8618,224
2759,8847.7,8845,12797,8621,224
2760,8859.09090909091,8849,12790,8625,224
2761,8862.6,8852,12789,8628,224
2762,8865.7,8855,12789,8631,224
2763,8868.1,8858,12790,8634,224
2764,8870.7,8862,12791,8637,225
2765,8872.7,8865,12792,8640,225
2766,8874.6,8868,12793,8643,225
2767,8877.2,8871,12794,8646,225
2768,8879.9,8874,12794,8650,224
2769,8883.6,8878,12794,8653,225
2770,8887.6,8881,12793,8656,225
2771,8890.6,8884,12793,8659,225
2772,8893.1,8887,12794,8662,225
2773,8895.0,8890,12795,8665,225
2774,8896.7,8894,12797,8668,226
2775,8898.7,8897,12798,8671,226
2776,8900.7,8900,12799,8675,225
2777,8903.5,8903,0,8678,225
2778,8906.7,8907,0,8681,226
2779,8908.8,8910,1,8684,226
2780,8914.1,8913,12799,8687,226
2781,8919.2,8916,12797,8690,226
2782,8921.6,8920,12798,8693,227
2783,8923.7,8923,12799,8696,227
2784,8925.9,8926,0,8700,226
2785,8927.9,8929,1,8703,226
2786,8930.4,8933,3,8706,227
2787,8933.0,8936,3,8709,227
2788,8933.363636363636,8939,6,8712,227
2789,8940.2,8942,2,8715,227
2790,8936.083333333334,8945,9,8718,227
2791,8948.9,8948,12799,8721,227
2792,8953.8,8952,12798,8725,227
2793,8956.9,8955,12798,8728,227
2794,8959.2,8958,12799,8731,227
2795,8961.1,8961,0,8734,227
2796,8962.9,8964,1,8737,227
2797,8966.0,8967,1,8740,227
2798,8969.1,8970,1,8743,227
2799,8971.7,8973,1,8746,227
2800,8997.125,8977,12780,8750,227
2801,8986.1,8980,12794,8753,227
2802,8989.2,8983,12794,8756,227
2803,8991.4,8986,12795,8759,227
2804,8993.6,8989,12795,8762,227
2805,8996.0,8992,12796,8765,227
2806,8998.6,8995,12796,8768,227
2807,9001.1,8998,12797,8771,227
2808,9000.181818181818,9001,1,8775,226
2809,9007.6,9005,12797,8778,227
2810,9006.181818181818,9008,2,8781,227
2811,9005.083333333334,9011,6,8784,227
2812,9008.5,9014,6,8787,227
2813,9022.4,9017,12795,8790,227
2814,9024.6,9020,12795,8793,227
2815,9026.5,9023,12796,8796,227
2816,9028.6,9026,12797,8800,226
2817,9030.9,9029,12798,8803,226
2818,9034.5,9032,12798,8806,226
2819,9038.0,9035,12797,8809,226
2820,9040.4,9038,12798,8812,226
2821,9045.6,9041,12795,8815,226
2822,9051.4,9045,12794,8818,227
2823,9054.0,9048,12794,8821,227
2824,9056.2,9051,12795,8825,226
2825,9058.8,9054,12795,8828,226
2826,9061.5,9057,12796,8831,226
2827,9063.9,9060,12796,8834,226
2828,9065.7,9063,12797,8837,226
2829,9061.666666666666,9066,4,8840,226
2830,9071.9,9069,12797,8843,226
2831,9055.8125,9072,16,8846,226
2832,9080.3,9075,12795,8850,225
2833,9064.6,9078,13,8853,225
2834,9088.0,9081,12793,8856,225
2835,9090.0,9084,12794,8859,225
2836,9091.9,9087,12795,8862,225
2837,9094.1,9091,12797,8865,226
2838,9096.7,9094,12797,8868,226
2839,9098.727272727272,9097,12798,8871,226
2840,9102.7,9100,12797,8875,225
2841,9125.4375,9103,12778,8878,225
2842,9115.9,9106,12790,8881,225
2843,9120.1,9109,12789,8884,225
2844,9122.2,9112,12790,8887,225
2845,9124.4,9115,12791,8890,225
2846,9126.7,9118,12791,8893,225
2847,9129.0,9121,12792,8896,225
2848,9131.0,9125,12794,8900,225
2849,9132.9,9128,12795,8903,225
2850,9128.083333333334,9131,3,8906,225
2851,9138.8,9134,12795,8909,225
2852,9141.8,9137,12795,8912,225
2853,9144.9,9140,12795,8915,225
2854,9148.1,9143,12795,8918,225
2855,9150.5,9146,12796,8921,225
2856,9152.3,9149,12797,8925,224
2857,9154.0,9152,12798,8928,224
2858,9155.7,9155,12799,8931,224
2859,9158.5,9158,0,8934,224
2860,9161.4,9161,0,8937,224
2861,9163.7,9165,1,8940,225
2862,9177.846153846154,9168,12790,8943,225
2863,9172.1,9171,12799,8946,225
2864,9175.7,9174,12798,8950,224
2865,9177.9,9177,12799,8953,224
2866,9180.3,9180,0,8956,224
2867,9182.2,9183,1,8959,224
2868,9184.2,9186,2,8962,224
2869,9186.4,9189,3,8965,224
2870,9188.6,9192,3,8968,224
2871,9192.3,9195,3,8971,224
2872,9195.8,9198,2,8975,223
2873,9199.1,9201,2,8978,223
2874,9203.3,9204,1,8981,223
2875,9207.8,9207,12799,8984,223
2876,9211.8,9210,12798,8987,223
2877,9214.3,9213,12799,8990,223
2878,9216.3,9216,0,8993,223
2879,9218.4,9219,1,8996,223
2880,9220.4,9222,2,9000,222
2881,9223.1,9225,2,9003,222
2882,9225.9,9228,2,9006,222
2883,9228.4,9231,3,9009,222
2884,9235.6,9234,12798,9012,222
2885,9243.2,9237,12794,9015,222
2886,9245.8,9240,12794,9018,222
2887,9247.8,9243,12795,9021,222
2888,9249.8,9246,12796,9025,221
2889,9252.1,9249,12797,9028,221
2890,9254.5,9252,12798,9031,221
2891,9257.1,9255,12798,9034,221
2892,9260.3,9258,12798,9037,221
2893,9263.4,9261,12798,9040,221
2894,9266.8,9264,12797,9043,221
2895,9270.0,9267,12797,9046,221
2896,9273.3,9270,12797,9050,220
2897,9271.454545454546,9273,2,9053,220
2898,9279.8,9276,12796,9056,220
2899,9281.9,9279,12797,9059,220
2900,9283.6,9282,12798,9062,220
2901,9285.4,9285,0,9065,220
2902,9288.6,9288,12799,9068,220
2903,9291.7,9291,12799,9071,220
2904,9294.1,9294,0,9075,219
2905,9314.733333333334,9296,12781,9078,218
2906,9303.6,9299,12795,9081,218
2907,9307.9,9302,12794,9084,218
2908,9310.2,9305,12795,9087,218
2909,9312.6,9308,12795,9090,218
2910,9314.8,9311,12796,9093,218
2911,9317.5,9314,12796,9096,218
2912,9319.5,9317,12798,9100,217
2913,9321.4,9320,12799,9103,217
2914,9324.3,9323,12799,9106,217
2915,9327.4,9326,12799,9109,217
2916,9330.4,9328,12798,9112,216
2917,9334.9,9331,12796,9115,216
2918,9339.7,9334,12794,9118,216
2919,9342.9,9337,12794,9121,216
2920,9344.8,9340,12795,9125,215
2921,9347.1,9343,12796,9128,215
2922,9348.8,9346,12797,9131,215
2923,9350.7,9349,12798,9134,215
2924,9353.5,9352,12798,9137,215
2925,9356.6,9355,12798,9140,215
2926,9359.1,9358,12799,9143,215
2927,9382.9375,9361,12778,9146,215
2928,9373.3,9364,12791,9150,214
2929,9376.1,9367,12791,9153,214
2930,9378.4,9369,12791,9156,213
2931,9380.8,9372,12791,9159,213
2932,9382.9,9375,12792,9162,213
2933,9385.1,9378,12793,9165,213
2934,9387.0,9381,12794,9168,213
2935,9388.6,9384,12795,9171,213
2936,9391.1,9387,12796,9175,212
2937,9394.0,9390,12796,9178,212
2938,9392.272727272728,9393,1,9181,212
2939,9400.3,9396,12796,9184,212
2940,9403.1,9399,12796,9187,212
2941,9405.5,9402,12796,9190,212
2942,9407.1,9405,12798,9193,212
2943,9408.8,9408,12799,9196,212
2944,9410.5,9411,0,9200,211
2945,9412.3,9414,2,9203,211
2946,9413.0,9417,4,9206,211
2947,9417.9,9420,2,9209,211
2948,9420.1,9423,3,9212,211
2949,9436.642857142857,9425,12788,9215,210
2950,9428.9,9428,12799,9218,210
2951,9432.0,9431,12799,9221,210
2952,9434.3,9434,0,9225,209
2953,9436.5,9437,0,9228,209
2954,9438.5,9440,2,9231,209
2955,9440.4,9443,3,9234,209
2956,9442.4,9446,4,9237,209
2957,9444.7,9449,4,9240,209
2958,9448.0,9452,4,9243,209
2959,9451.5,9455,4,9246,209
2960,9455.1,9457,2,9250,207
2961,9459.4,9460,1,9253,207
2962,9463.5,9463,0,9256,207
2963,9467.0,9466,12799,9259,207
2964,9469.4,9469,0,9262,207
2965,9471.5,9472,0,9265,207
2966,9473.4,9475,2,9268,207
2967,9476.1,9478,2,9271,207
2968,9478.7,9481,2,9275,206
2969,9480.9,9483,2,9278,205
2970,9483.2,9486,3,9281,205
2971,9485.5,9489,4,9284,205
2972,9492.5,9492,0,9287,205
2973,9499.7,9495,12795,9290,205
2974,9502.5,9498,12796,9293,205
2975,9504.8,9500,12795,9296,204
2976,9507.0,9503,12796,9300,203
2977,9509.0,9506,12797,9303,203
2978,9511.0,9509,12798,9306,203
2979,9513.2,9512,12799,9309,203
2980,9516.2,9515,12799,9312,203
2981,9519.8,9518,12798,9315,203
2982,9523.0,9520,12797,9318,202
2983,9526.5,9523,12796,9321,202
2984,9529.7,9526,12796,9325,201
2985,9526.636363636364,9529,2,9328,201
2986,9535.2,9532,12797,9331,201
2987,9537.1,9535,12798,9334,201
2988,9539.0,9537,12798,9337,200
2989,9542.3,9540,12798,9340,200
2990,9545.4,9543,12798,9343,200
2991,9547.4,9546,12799,9346,200
2992,9549.6,9549,12799,9350,199
2993,9546.777777777777,9551,4,9353,198
2994,9569.42857142857,9554,12785,9356,198
2995,9560.6,9557,12796,9359,198
2996,9565.2,9560,12795,9362,198
2997,9567.9,9563,12795,9365,198
2998,9570.1,9565,12795,9368,197
2999,9572.2,9568,12796,9371,197
3000,9574.0,9571,12797,9375,196
3001,9576.2,9574,12798,9378,196
3002,9579.5,9577,12798,9381,196
3003,9582.4,9580,12798,9384,196
3004,9584.7,9582,12797,9387,195
3005,9579.833333333334,9585,5,9390,195
3006,9591.5,9588,12796,9393,195
3007,9595.9,9591,12795,9396,195
3008,9599.1,9594,12795,9400,194
3009,9601.5,9597,12796,9403,194
3010,9603.4,9600,12797,9406,194
3011,9605.4,9602,12797,9409,193
3012,9607.545454545454,9605,12797,9412,193
3013,9610.3,9608,12798,9415,193
3014,9612.4,9611,12799,9418,193
3015,9614.8,9614,12799,9421,193
3016,9617.9,9617,12799,9425,192
3017,9625.0,9620,12795,9428,192
3018,9631.8,9622,12790,9431,191
3019,9634.1,9625,12791,9434,191
3020,9636.2,9628,12792,9437,191
3021,9638.4,9631,12793,9440,191
3022,9640.5,9634,12794,9443,191
3023,9642.5,9637,12794,9446,191
3024,9644.7,9640,12795,9450,190
3025,9643.363636363636,9643,0,9453,190
3026,9649.1,9645,12796,9456,189
3027,9651.8,9648,12796,9459,189
3028,9655.1,9651,12796,9462,189
3029,9652.727272727272,9654,1,9465,189
3030,9655.181818181818,9657,2,9468,189
3031,9662.5,9660,12798,9471,189
3032,9664.3,9663,12799,9475,188
3033,9666.1,9666,0,9478,188
3034,9668.6,9668,12799,9481,187
3035,9671.3,9671,0,9484,187
3036,9672.7,9674,1,9487,187
3037,9674.5,9677,2,9490,187
3038,9676.6,9680,3,9493,187
3039,9690.153846153846,9683,12793,9496,187
3040,9684.8,9685,0,9500,185
3041,9688.7,9688,12799,9503,185
3042,9690.7,9691,0,9506,185
3043,9692.7,9694,1,9509,185
3044,9694.6,9697,2,9512,185
3045,9696.8,9700,3,9515,185
3046,9699.0,9702,3,9518,184
3047,9701.9,9705,3,9521,184
3048,9705.0,9708,3,9525,183
3049,9708.5,9711,2,9528,183
3050,9711.8,9714,2,9531,183
3051,9715.3,9717,2,9534,183
3052,9719.8,9720,0,9537,183
3053,9723.0,9722,12799,9540,182
3054,9725.5,9725,0,9543,182
3055,9727.6,9728,0,9546,182
3056,9730.0,9731,1,9550,181
3057,9732.6,9734,1,9553,181
3058,9734.8,9737,2,9556,181
3059,9736.6,9739,2,9559,180
3060,9738.8,9742,3,9562,180
3061,9740.9,9745,4,9565,180
3062,9750.916666666666,9748,12797,9568,180
3063,9750.7,9751,0,9571,180
3064,9757.5,9753,12796,9575,178
3065,9759.9,9756,12796,9578,178
3066,9761.9,9759,12797,9581,178
3067,9763.9,9762,12798,9584,178
3068,9766.4,9765,12799,9587,178
3069,9769.2,9767,12798,9590,177
3070,9771.8,9770,12798,9593,177
3071,9774.3,9773,12799,9596,177
3072,9777.5,9776,12798,9600,176
3073,9781.3,9779,12798,9603,176
3074,9785.0,9781,12796,9606,175
3075,9787.8,9784,12796,9609,175
3076,9790.1,9787,12797,9612,175
3077,9792.6,9790,12797,9615,175
3078,9794.7,9793,12798,9618,175
3079,9797.363636363636,9796,12799,9621,175
3080,9800.9,9798,12797,9625,173
3081,9803.0,9801,12798,9628,173
3082,9804.9,9804,12799,9631,173
3083,9807.0,9807,0,9634,173
3084,9809.4,9810,1,9637,173
3085,9811.4,9812,1,9640,172
3086,9816.9,9815,12798,9643,172
3087,9822.5,9818,12796,9646,172
3088,9825.0,9821,12796,9650,171
3089,9827.6,9823,12795,9653,170
3090,9829.2,9826,12797,9656,170
3091,9831.4,9829,12798,9659,170
3092,9834.1,9832,12798,9662,170
3093,9837.3,9835,12798,9665,170
3094,9840.6,9838,12797,9668,170
3095,9844.7,9840,12795,9671,169
3096,9847.8,9843,12795,9675,168
3097,9841.5,9846,4,9678,168
3098,9853.7,9849,12795,9681,168
3099,9856.1,9852,12796,9684,168
3100,9858.4,9855,12797,9687,168
3101,9861.3,9857,12796,9690,167
3102,9863.5,9860,12796,9693,167
3103,9865.5,9863,12798,9696,167
3104,9867.6,9866,12798,9700,166
3105,9869.7,9869,12799,9703,166
3106,9871.5,9872,0,9706,166
3107,9873.5,9875,2,9709,166
3108,9876.4,9878,2,9712,166
3109,9883.8,9880,12796,9715,165
3110,9890.9,9883,12792,9718,165
3111,9893.0,9886,12793,9721,165
3112,9894.8,9889,12794,9725,164
3113,9896.7,9892,12795,9728,164
3114,9899.1,9895,12796,9731,164
3115,9901.6,9898,12796,9734,164
3116,9904.2,9900,12796,9737,163
3117,9899.083333333334,9903,4,9740,163
3118,9909.7,9906,12796,9743,163
3119,9913.2,9909,12796,9746,163
3120,9915.8,9912,12796,9750,162
3121,9917.5,9915,12798,9753,162
3122,9919.2,9918,12799,9756,162
3123,9922.0,9920,12798,9759,161
3124,9924.6,9923,12798,9762,161
3125,9926.3,9926,0,9765,161
3126,9927.8,9929,1,9768,161
3127,9929.6,9932,2,9771,161
3128,9931.2,9935,4,9775,160
3129,9933.1,9938,5,9778,160
3130,9935.4,9941,6,9781,160
3131,9949.461538461539,9943,12794,9784,159
3132,9945.0,9946,1,9787,159
3133,9947.8,9949,1,9790,159
3134,9949.7,9952,2,9793,159
3135,9951.7,9955,3,9796,159
3136,9954.7,9958,3,9800,158
3137,9958.1,9961,3,9803,158
3138,9960.1,9963,3,9806,157
3139,9963.0,9966,3,9809,157
3140,9967.1,9969,2,9812,157
3141,9971.6,9972,0,9815,157
3142,9975.0,9975,0,9818,157
3143,9977.5,9978,0,9821,157
3144,9979.8,9981,1,9825,156
3145,9982.8,9983,0,9828,155
3146,9985.7,9986,0,9831,155
3147,9987.6,9989,1,9834,155
3148,9989.7,9992,2,9837,155
3149,9991.5,9995,4,9840,155
3150,9993.6,9998,4,9843,155
3151,9995.8,10001,5,9846,155
3152,9997.8,10004,6,9850,154
3153,10000.3,10006,6,9853,153
3154,10021.533333333333,10009,12787,9856,153
3155,10014.1,10012,12798,9859,153
3156,10017.0,10015,12798,9862,153
3157,10019.5,10018,12798,9865,153
3158,10022.6,10020,12797,9868,152
3159,10025.4,10023,12798,9871,152
3160,10027.6,10026,12798,9875,151
3161,10030.2,10029,12799,9878,151
3162,10033.5,10032,12798,9881,151
3163,10037.3,10035,12798,9884,151
3164,10041.1,10037,12796,9887,150
3165,10043.6,10040,12796,9890,150
3166,10045.6,10043,12797,9893,150
3167,10047.9,10046,12798,9896,150
3168,10051.4,10049,12798,9900,149
3169,10054.5,10052,12798,9903,149
3170,10056.8,10055,12798,9906,149
3171,10059.0,10057,12798,9909,148
3172,10061.5,10060,12798,9912,148
3173,10063.9,10063,12799,9915,148
3174,10066.0,10066,0,9918,148
3175,10063.333333333334,10069,6,9921,148
3176,10070.2,10072,2,9925,147
3177,10079.90909090909,10074,12794,9928,146
3178,10080.8,10077,12796,9931,146
3179,10083.7,10080,12796,9934,146
3180,10086.4,10083,12797,9937,146
3181,10075.266666666666,10086,11,9940,146
3182,10092.2,10089,12797,9943,146
3183,10095.3,10091,12796,9946,145
3184,10099.3,10094,12795,9950,144
3185,10103.7,10097,12793,9953,144
3186,10106.8,10100,12793,9956,144
3187,10108.8,10103,12794,9959,144
3188,10110.8,10106,12795,9962,144
3189,10113.0,10109,12796,9965,144
3190,10115.9,10112,12796,9968,144
3191,10118.3,10115,12797,9971,144
3192,10120.4,10117,12797,9975,142
3193,10122.6,10120,12797,9978,142
3194,10125.0,10123,12798,9981,142
3195,10127.3,10126,12799,9984,142
3196,10129.3,10129,0,9987,142
3197,10131.2,10132,1,9990,142
3198,10133.4,10135,2,9993,142
3199,10145.0,10138,12793,9996,142
3200,10146.0,10141,12795,10000,141
3201,10150.1,10144,12794,10003,141
3202,10152.6,10147,12794,10006,141
3203,10148.416666666666,10150,2,10009,141
3204,10157.5,10153,12796,10012,141
3205,10160.0,10155,12795,10015,140
3206,10163.2,10158,12795,10018,140
3207,10166.6,10161,12794,10021,140
3208,10169.3,10164,12795,10025,139
3209,10171.1,10167,12796,10028,139
3210,10173.4,10170,12797,10031,139
3211,10175.6,10173,12797,10034,139
3212,10177.538461538461,10176,12798,10037,139
3213,10180.2,10179,12799,10040,139
3214,10181.9,10182,0,10043,139
3215,10184.0,10185,1,10046,139
3216,10185.9,10188,2,10050,138
3217,10187.6,10191,3,10053,138
3218,10189.4,10194,5,10056,138
3219,10191.3,10197,6,10059,138
3220,10193.5,10200,6,10062,138
3221,10197.5,10203,6,10065,138
3222,10202.6,10206,3,10068,138
3223,10206.0,10208,2,10071,137
3224,10209.0,10211,2,10075,136
3225,10212.0,10214,2,10078,136
3226,10215.0,10217,2,10081,136
3227,10218.7,10220,1,10084,136
3228,10214.333333333334,10223,9,10087,136
3229,10225.2,10226,1,10090,136
3230,10229.0,10229,0,10093,136
3231,10231.6,10232,0,10096,136
3232,10233.8,10235,1,10100,135
3233,10236.6,10238,1,10103,135
3234,10239.3,10241,2,10106,135
3235,10242.0,10244,2,10109,135
3236,10244.5,10247,2,10112,135
3237,10246.8,10250,3,10115,135
3238,10248.9,10253,4,10118,135
3239,10250.7,10256,5,10121,135
3240,10252.8,10259,6,10125,134
3241,10254.8,10262,7,10128,134
3242,10256.8,10264,7,10131,133
3243,10259.6,10267,7,10134,133
3244,10267.0,10270,3,10137,133
3245,10274.8,10273,12798,10140,133
3246,10277.9,10276,12798,10143,133
3247,10280.6,10279,12798,10146,133
3248,10279.636363636364,10282,2,10150,132
3249,10282.454545454546,10285,3,10153,132
3250,10290.9,10288,12797,10156,132
3251,10293.8,10291,12797,10159,132
3252,10296.3,10294,12798,10162,132
3253,10298.8,10297,12798,10165,132
3254,10302.2,10299,12797,10168,131
3255,10305.9,10302,12796,10171,131
3256,10308.7,10305,12796,10175,130
3257,10311.6,10308,12796,10178,130
3258,10314.1,10311,12797,10181,130
3259,10316.2,10314,12798,10184,130
3260,10318.6,10317,12798,10187,130
3261,10320.9,10320,12799,10190,130
3262,10323.3,10323,0,10193,130
3263,10325.8,10326,0,10196,130
3264,10328.3,10329,1,10200,129
3265,10330.2,10332,2,10203,129
3266,10335.4,10335,0,10206,129
3267,10333.76923076923,10338,4,10209,129
3268,10345.9,10341,12795,10212,129
3269,10338.923076923076,10344,5,10215,129
3270,10353.0,10346,12793,10218,128
3271,10357.3,10349,12792,10221,128
3272,10360.7,10352,12791,10225,127
3273,10362.8,10355,12792,10228,127
3274,10364.6,10358,12793,10231,127
3275,10366.7,10361,12794,10234,127
3276,10369.416666666666,10364,12795,10237,127
3277,10372.1,10367,12795,10240,127
3278,10375.1,10371,12796,10243,128
3279,10377.6,10374,12796,10246,128
3280,10379.6,10377,12797,10250,127
3281,10381.7,10380,12798,10253,127
3282,10383.6,10383,12799,10256,127
3283,10385.7,10386,0,10259,127
3284,10387.9,10389,1,10262,127
3285,10390.1,10392,2,10265,127
3286,10392.3,10395,3,10268,127
3287,10405.615384615385,10398,12792,10271,127
3288,10402.0,10401,12799,10275,126
3289,10410.2,10404,12794,10278,126
3290,10413.1,10407,12794,10281,126
3291,10416.5,10410,12794,10284,126
3292,10415.454545454546,10413,12798,10287,126
3293,10422.5,10417,12794,10290,127
3294,10424.4,10420,12796,10293,127
3295,10426.3,10423,12797,10296,127
3296,10428.5,10426,12798,10300,126
3297,10432.181818181818,10429,12797,10303,126
3298,10434.5,10432,12798,10306,126
3299,10436.7,10435,12798,10309,126
3300,10438.5,10438,0,10312,126
3301,10440.2,10441,1,10315,126
3302,10442.0,10444,2,10318,126
3303,10444.0,10447,3,10321,126
3304,10445.9,10450,4,10325,125
3305,10448.2,10454,6,10328,126
3306,10450.1,10457,7,10331,126
3307,10452.5,10460,8,10334,126
3308,10462.0,10463,1,10337,126
3309,10462.2,10466,4,10340,126
3310,10467.7,10469,1,10343,126
3311,10471.1,10472,1,10346,126
3312,10464.76923076923,10475,10,10350,125
3313,10471.75,10478,6,10353,125
3314,10481.9,10482,0,10356,126
3315,10484.1,10485,1,10359,126
3316,10486.2,10488,2,10362,126
3317,10489.4,10491,2,10365,126
3318,10492.4,10494,2,10368,126
3319,10494.8,10497,2,10371,126
3320,10497.4,10500,3,10375,125
3321,10500.1,10503,3,10378,125
3322,10502.5,10506,4,10381,125
3323,10504.7,10509,4,10384,125
3324,10506.8,10512,5,10387,125
3325,10509.0,10515,6,10390,125
3326,10511.3,10518,7,10393,125
3327,10513.8,10521,7,10396,125
3328,10516.9,10524,7,10400,124
3329,10520.1,10528,8,10403,125
3330,10527.7,10531,3,10406,125
3331,10532.09090909091,10534,2,10409,125
3332,10535.181818181818,10537,2,10412,125
3333,10534.916666666666,10540,5,10415,125
3334,10546.7,10543,12796,10418,125
3335,10549.0,10546,12797,10421,125
3336,10551.4,10549,12798,10425,124
3337,10554.6,10552,12797,10428,124
3338,10558.4,10555,12797,10431,124
3339,10561.5,10559,12798,10434,125
3340,10564.7,10562,12797,10437,125
3341,10567.7,10565,12797,10440,125
3342,10570.5,10568,12798,10443,125
3343,10573.4,10571,12798,10446,125
3344,10575.9,10574,12798,10450,124
3345,10578.2,10577,12799,10453,124
3346,10580.6,10580,12799,10456,124
3347,10583.1,10583,0,10459,124
3348,10585.8,10586,0,10462,124
3349,10584.583333333334,10589,4,10465,124
3350,10595.363636363636,10593,12798,10468,125
3351,10589.76923076923,10596,6,10471,125
3352,10602.454545454546,10599,12797,10475,124
3353,10605.818181818182,10602,12796,10478,124
3354,10614.2,10605,12791,10481,124
3355,10616.5,10608,12792,10484,124
3356,10618.8,10612,12793,10487,125
3357,10621.7,10615,12793,10490,125
3358,10624.5,10618,12794,10493,125
3359,10626.7,10621,12794,10496,125
3360,10629.1,10624,12795,10500,124
3361,10631.3,10627,12796,10503,124
3362,10633.6,10631,12797,10506,125
3363,10636.4,10634,12798,10509,125
3364,10638.8,10637,12798,10512,125
3365,10641.3,10640,12799,10515,125
3366,10643.1,10643,0,10518,125
3367,10645.0,10647,2,10521,126
3368,10646.9,10650,3,10525,125
3369,10649.8,10653,3,10528,125
3370,10654.0,10656,2,10531,125
3371,10661.8,10660,12798,10534,126
3372,10663.25,10663,0,10537,126
3373,10673.8,10666,12792,10540,126
3374,10675.8,10670,12794,10543,127
3375,10678.1,10673,12795,10546,127
3376,10680.1,10676,12796,10550,126
3377,10683.2,10679,12796,10553,126
3378,10686.3,10683,12797,10556,127
3379,10688.3,10686,12798,10559,127
3380,10690.7,10689,12798,10562,127
3381,10693.0,10692,12799,10565,127
3382,10694.8,10696,1,10568,128
3383,10697.0,10699,2,10571,128
3384,10699.3,10702,3,10575,127
3385,10701.4,10705,4,10578,127
3386,10703.3,10708,5,10581,127
3387,10705.4,10712,7,10584,128
3388,10708.4,10715,7,10587,128
3389,10711.4,10718,7,10590,128
3390,10714.9,10722,7,10593,129
3391,10722.2,10725,3,10596,129
3392,10729.2,10728,12799,10600,128
3393,10733.0,10732,12799,10603,129
3394,10735.7,10735,12799,10606,129
3395,10737.9,10738,0,10609,129
3396,10740.0,10742,2,10612,130
3397,10742.5,10745,2,10615,130
3398,10745.3,10748,3,10618,130
3399,10748.7,10751,2,10621,130
3400,10751.3,10755,4,10625,130
3401,10753.8,10758,4,10628,130
3402,10756.1,10761,5,10631,130
3403,10758.6,10764,5,10634,130
3404,10761.1,10767,6,10637,130
3405,10763.6,10771,7,10640,131
3406,10766.5,10774,8,10643,131
3407,10769.6,10777,7,10646,131
3408,10772.6,10780,7,10650,130
3409,10775.7,10784,8,10653,131
3410,10779.6,10787,7,10656,131
3411,10800.421052631578,10790,12790,10659,131
3412,10795.8,10793,12797,10662,131
3413,10800.1,10797,12797,10665,132
3414,10802.6,10800,12797,10668,132
3415,10805.0,10803,12798,10671,132
3416,10808.6,10807,12798,10675,132
3417,10812.2,10810,12798,10678,132
3418,10815.3,10813,12798,10681,132
3419,10819.0,10816,12797,10684,132
3420,10822.2,10819,12797,10687,132
3421,10825.0,10823,12798,10690,133
3422,10827.7,10826,12798,10693,133
3423,10830.9,10829,12798,10696,133
3424,10833.8,10832,12798,10700,132
3425,10836.1,10836,0,10703,133
3426,10839.8,10839,12799,10706,133
3427,10843.4,10842,12799,10709,133
3428,10847.1,10846,12799,10712,134
3429,10851.5,10849,12798,10715,134
3430,10856.1,10852,12796,10718,134
3431,10862.4,10856,12794,10721,135
3432,10868.5,10859,12790,10725,134
3433,10871.2,10862,12791,10728,134
3434,10873.5,10866,12792,10731,135
3435,10876.5,10869,12792,10734,135
3436,10879.7,10872,12792,10737,135
3437,10882.1,10876,12794,10740,136
3438,10884.6,10879,12794,10743,136
3439,10886.8,10882,12795,10746,136
3440,10889.1,10886,12797,10750,136
3441,10891.9,10889,12797,10753,136
3442,10894.6,10892,12797,10756,136
3443,10896.8,10896,12799,10759,137
3444,10899.0,10899,0,10762,137
3445,10901.1,10902,1,10765,137
3446,10899.916666666666,10906,6,10768,138
3447,10907.0,10909,2,10771,138
3448,10910.9,10913,2,10775,138
3449,10914.4,10916,2,10778,138
3450,10924.545454545454,10920,12795,10781,139
3451,10929.3,10923,12794,10784,139
3452,10932.1,10926,12794,10787,139
3453,10934.5,10930,12796,10790,140
3454,10937.7,10933,12795,10793,140
3455,10940.8,10937,12796,10796,141
3456,10943.4,10940,12797,10800,140
3457,10945.6,10944,12798,10803,141
3458,10947.5,10947,0,10806,141
3459,10950.2,10950,0,10809,141
3460,10952.7,10954,1,10812,142
3461,10954.6,10957,2,10815,142
3462,10957.0,10960,3,10818,142
3463,10959.5,10964,4,10821,143
3464,10962.3,10967,5,10825,142
3465,10965.5,10971,6,10828,143
3466,10968.6,10974,5,10831,143
3467,10973.2,10978,5,10834,144
3468,10967.92857142857,10981,13,10837,144
3469,10986.363636363636,10984,12798,10840,144
3470,10989.3,10988,12799,10843,145
3471,10991.9,10991,12799,10846,145
3472,10994.5,10995,0,10850,145
3473,10997.1,10998,1,10853,145
3474,10999.9,11002,2,10856,146
3475,11002.1,11005,3,10859,146
3476,11004.8,11008,3,10862,146
3477,11008.1,11012,4,10865,147
3478,11010.8,11015,4,10868,147
3479,11013.3,11018,5,10871,147
3480,11015.9,11022,6,10875,147
3481,11018.8,11025,6,10878,147
3482,11022.0,11029,7,10881,148
3483,11025.6,11032,6,10884,148
3484,11029.1,11035,6,10887,148
3485,11033.1,11039,6,10890,149
3486,11036.6,11042,5,10893,149
3487,11039.9,11046,6,10896,150
3488,11057.111111111111,11049,12792,10900,149
3489,11053.1,11052,12799,10903,149
3490,11058.5,11056,12798,10906,150
3491,11062.4,11059,12797,10909,150
3492,11066.2,11062,12796,10912,150
3493,11069.0,11066,12797,10915,151
3494,11072.1,11069,12797,10918,151
3495,11075.1,11073,12798,10921,152
3496,11078.5,11076,12798,10925,151
3497,11082.2,11079,12797,10928,151
3498,11085.3,11083,12798,10931,152
3499,11088.3,11086,12798,10934,152
3500,11091.2,11089,12798,10937,152
3501,11095.1,11093,12798,10940,153
3502,11099.3,11096,12797,10943,153
3503,11101.09090909091,11100,12799,10946,154
3504,11106.181818181818,11103,12797,10950,153
3505,11112.8,11107,12794,10953,154
3506,11115.2,11110,12795,10956,154
3507,11120.4,11114,12794,10959,155
3508,11126.2,11117,12791,10962,155
3509,11129.9,11120,12790,10965,155
3510,11133.5,11124,12790,10968,156
3511,11136.4,11127,12791,10971,156
3512,11138.7,11131,12792,10975,156
3513,11141.1,11134,12793,10978,156
3514,11143.6,11138,12794,10981,157
3515,11145.9,11141,12795,10984,157
3516,11148.1,11145,12797,10987,158
3517,11150.1,11148,12798,10990,158
3518,11153.0,11152,12799,10993,159
3519,11156.0,11155,12799,10996,159
3520,11159.1,11159,0,11000,159
3521,11162.0,11162,0,11003,159
3522,11165.5,11166,0,11006,160
3523,11168.7,11169,0,11009,160
3524,11171.4,11173,2,11012,161
3525,11174.2,11176,2,11015,161
3526,11182.0,11180,12798,11018,162
3527,11189.0,11183,12794,11021,162
3528,11192.6,11187,12794,11025,162
3529,11195.9,11190,12794,11028,162
3530,11198.2,11194,12796,11031,163
3531,11200.3,11197,12797,11034,163
3532,11202.7,11201,12798,11037,164
3533,11205.5,11204,12798,11040,164
3534,11208.3,11208,0,11043,165
3535,11210.4,11211,1,11046,165
3536,11212.6,11215,2,11050,165
3537,11214.8,11218,3,11053,165
3538,11216.272727272728,11222,6,11056,166
3539,11222.3,11225,3,11059,166
3540,11226.9,11229,2,11062,167
3541,11227.454545454546,11232,5,11065,167
3542,11234.6,11236,1,11068,168
3543,11236.7,11239,2,11071,168
3544,11241.8,11243,1,11075,168
3545,11247.2,11246,12799,11078,168
3546,11250.5,11250,0,11081,169
3547,11253.9,11253,12799,11084,169
3548,11256.6,11257,0,11087,170
3549,11258.7,11260,1,11090,170
3550,11261.3,11264,3,11093,171
3551,11263.9,11267,3,11096,171
3552,11266.7,11271,4,11100,171
3553,11270.0,11274,4,11103,171
3554,11272.7,11278,5,11106,172
3555,11276.3,11281,5,11109,172
3556,11279.9,11285,5,11112,173
3557,11283.0,11288,5,11115,173
3558,11287.1,11292,5,11118,174
3559,11290.5,11295,4,11121,174
3560,11294.2,11299,5,11125,174
3561,11297.3,11302,5,11128,174
3562,11316.545454545454,11306,12789,11131,175
3563,11311.2,11309,12798,11134,175
3564,11316.2,11312,12796,11137,175
3565,11320.1,11316,12796,11140,176
3566,11323.4,11319,12796,11143,176
3567,11326.7,11323,12796,11146,177
3568,11329.9,11326,12796,11150,176
3569,11333.2,11330,12797,11153,177
3570,11336.6,11333,12796,11156,177
3571,11339.6,11336,12796,11159,177
3572,11342.5,11340,12798,11162,178
3573,11345.7,11343,12797,11165,178
3574,11343.642857142857,11347,3,11168,179
3575,11355.1,11350,12795,11171,179
3576,11359.6,11354,12794,11175,179
3577,11364.2,11357,12793,11178,179
3578,11368.1,11361,12793,11181,180
3579,11370.4,11364,12794,11184,180
3580,11372.9,11368,12795,11187,181
3581,11378.3,11371,12793,11190,181
3582,11384.9,11375,12790,11193,182
3583,11388.8,11378,12789,11196,182
3584,11391.4,11381,12790,11200,181
3585,11393.8,11385,12791,11203,182
3586,11396.2,11389,12793,11206,183
3587,11398.7,11392,12793,11209,183
3588,11401.1,11396,12795,11212,184
3589,11403.7,11399,12795,11215,184
3590,11406.2,11403,12797,11218,185
3591,11408.6,11406,12797,11221,185
3592,11411.6,11410,12798,11225,185
3593,11414.5,11413,12798,11228,185
3594,11417.8,11417,12799,11231,186
3595,11421.2,11420,12799,11234,186
3596,11419.25,11424,5,11237,187
3597,11427.3,11427,0,11240,187
3598,11430.1,11431,1,11243,188
3599,11440.333333333334,11434,12794,11246,188
3600,11444.4,11438,12794,11250,188
3601,11450.076923076924,11441,12791,11253,188
3602,11451.6,11445,12793,11256,189
3603,11454.1,11449,12795,11259,190
3604,11456.5,11452,12796,11262,190
3605,11458.6,11456,12797,11265,191
3606,11460.8,11459,12798,11268,191
3607,11463.4,11463,0,11271,192
3608,11465.8,11466,0,11275,191
3609,11468.3,11470,2,11278,192
3610,11471.7,11473,1,11281,192
3611,11475.0,11477,2,11284,193
3612,11478.3,11480,2,11287,193
3613,11482.5,11484,2,11290,194
3614,11486.7,11487,0,11293,194
3615,11489.9,11491,1,11296,195
3616,11492.2,11494,2,11300,194
3617,11497.454545454546,11498,1,11303,195
3618,11501.9,11501,12799,11306,195
3619,11507.3,11505,12798,11309,196
3620,11509.8,11508,12798,11312,196
3621,11512.3,11512,0,11315,197
3622,11514.6,11515,0,11318,197
3623,11516.9,11519,2,11321,198
3624,11519.9,11522,2,11325,197
3625,11522.8,11526,3,11328,198
3626,11525.2,11529,4,11331,198
3627,11528.0,11533,5,11334,199
3628,11531.5,11536,4,11337,199
3629,11535.0,11540,5,11340,200
3630,11538.7,11543,4,11343,200
3631,11543.1,11547,4,11346,201
3632,11546.9,11550,3,11350,200
3633,11549.8,11553,3,11353,200
3634,11552.5,11557,4,11356,201
3635,11555.1,11560,5,11359,201
3636,11562.8,11564,1,11362,202
3637,11571.6,11567,12795,11365,202
3638,11576.0,11571,12795,11368,203
3639,11579.4,11574,12795,11371,203
3640,11582.4,11577,12795,11375,202
3641,11585.4,11581,12796,11378,203
3642,11588.5,11584,12796,11381,203
3643,11591.8,11588,12796,11384,204
3644,11594.9,11591,12796,11387,204
3645,11598.4,11594,12796,11390,204
3646,11601.8,11598,12796,11393,205
3647,11599.692307692309,11601,1,11396,205
3648,11609.4,11605,12796,11400,205
3649,11610.181818181818,11608,12798,11403,205
3650,11617.6,11612,12794,11406,206
3651,11622.0,11615,12793,11409,206
3652,11625.8,11618,12792,11412,206
3653,11628.6,11622,12793,11415,207
3654,11635.636363636364,11625,12789,11418,207
3655,11639.5,11629,12790,11421,208
3656,11643.6,11632,12788,11425,207
3657,11646.5,11636,12790,11428,208
3658,11649.1,11639,12790,11431,208
3659,11651.8,11643,12791,11434,209
3660,11654.3,11646,12792,11437,209
3661,11656.6,11650,12793,11440,210
3662,11659.0,11653,12794,11443,210
3663,11661.1,11657,12796,11446,211
3664,11663.5,11660,12796,11450,210
3665,11666.7,11663,12796,11453,210
3666,11669.9,11667,12797,11456,211
3667,11673.0,11670,12797,11459,211
3668,11676.2,11674,12798,11462,212
3669,11679.6,11677,12797,11465,212
3670,11682.3,11681,12799,11468,213
3671,11684.4,11684,0,11471,213
3672,11687.2,11688,1,11475,213
3673,11695.8,11691,12795,11478,213
3674,11704.1,11695,12791,11481,214
3675,11706.5,11698,12792,11484,214
3676,11708.8,11702,12793,11487,215
3677,11710.9,11705,12794,11490,215
3678,11712.9,11709,12796,11493,216
3679,11715.0,11712,12797,11496,216
3680,11717.2,11715,12798,11500,215
3681,11719.8,11719,12799,11503,216
3682,11722.7,11722,12799,11506,216
3683,11725.4,11726,1,11509,217
3684,11728.6,11729,0,11512,217
3685,11731.5,11732,0,11515,217
3686,11734.4,11736,2,11518,218
3687,11738.5,11739,0,11521,218
3688,11742.8,11743,0,11525,218
3689,11746.3,11746,0,11528,218
3690,11748.9,11750,1,11531,219
3691,11758.0,11753,12795,11534,219
3692,11759.3,11757,12798,11537,220
3693,11763.0,11760,12797,11540,220
3694,11765.6,11764,12798,11543,221
3695,11768.2,11767,12799,11546,221
3696,11770.7,11770,12799,11550,220
3697,11773.0,11774,1,11553,221
3698,11775.5,11777,2,11556,221
3699,11778.2,11781,3,11559,222
3700,11780.6,11784,3,11562,222
3701,11783.2,11787,4,11565,222
3702,11787.2,11791,4,11568,223
3703,11790.7,11794,3,11571,223
3704,11793.9,11797,3,11575,222
3705,11795.0,11801,6,11578,223
3706,11800.6,11804,3,11581,223
3707,11803.9,11808,4,11584,224
3708,11807.1,11811,4,11587,224
3709,11810.3,11814,4,11590,224
3710,11823.92857142857,11818,12794,11593,225
3711,11829.615384615385,11821,12791,11596,225
3712,11830.6,11824,12793,11600,224
3713,11833.4,11828,12795,11603,225
3714,11836.5,11831,12794,11606,225
3715,11839.9,11834,12794,11609,225
3716,11842.8,11838,12795,11612,226
3717,11845.7,11841,12795,11615,226
3718,11848.8,11844,12795,11618,226
3719,11851.6,11847,12795,11621,226
3720,11854.8,11851,12796,11625,226
3721,11857.9,11854,12796,11628,226
3722,11855.142857142857,11857,2,11631,226
3723,11865.5,11860,12794,11634,226
3724,11869.2,11864,12795,11637,227
3725,11873.7,11867,12793,11640,227
3726,11878.0,11870,12792,11643,227
3727,11881.3,11873,12792,11646,227
3728,11883.8,11877,12793,11650,227
3729,11889.0,11880,12791,11653,227
3730,11894.0,11884,12790,11656,228
3731,11899.2,11887,12788,11659,228
3732,11901.8,11890,12788,11662,228
3733,11904.5,11894,12790,11665,229
3734,11906.8,11897,12790,11668,229
3735,11909.1,11900,12791,11671,229
3736,11911.2,11904,12793,11675,229
3737,11913.8,11907,12793,11678,229
3738,11916.1,11910,12794,11681,229
3739,11918.2,11914,12796,11684,230
3740,11921.0,11917,12796,11687,230
3741,11923.8,11920,12796,11690,230
3742,11926.4,11923,12797,11693,230
3743,11929.2,11927,12798,11696,231
3744,11932.6,11930,12797,11700,230
3745,11935.7,11933,12797,11703,230
3746,11933.416666666666,11937,4,11706,231
3747,11940.9,11940,12799,11709,231
3748,11947.272727272728,11944,12797,11712,232
3749,11952.2,11947,12795,11715,232
3750,11959.3,11950,12791,11718,232
3751,11962.3,11954,12792,11721,233
3752,11964.7,11957,12792,11725,232
3753,11966.8,11960,12793,11728,232
3754,11968.8,11964,12795,11731,233
3755,11970.8,11967,12796,11734,233
3756,11973.0,11970,12797,11737,233
3757,11976.1,11974,12798,11740,234
3758,11975.444444444445,11977,2,11743,234
3759,11980.0,11980,0,11746,234
3760,11983.5,11983,0,11750,233
3761,11986.6,11987,0,11753,234
3762,11988.7,11990,1,11756,234
3763,11991.6,11993,1,11759,234
3764,11995.6,11996,0,11762,234
3765,12000.0,12000,0,11765,235
3766,12003.3,12003,0,11768,235
3767,12005.9,12007,1,11771,236
3768,12015.538461538461,12010,12794,11775,235
3769,12016.5,12013,12796,11778,235
3770,12019.4,12017,12798,11781,236
3771,12021.7,12020,12798,11784,236
3772,12024.0,12023,12799,11787,236
3773,12026.4,12026,0,11790,236
3774,12028.7,12030,1,11793,237
3775,12030.9,12033,2,11796,237
3776,12033.5,12036,2,11800,236
3777,12035.9,12039,3,11803,236
3778,12038.4,12042,4,11806,236
3779,12041.4,12046,5,11809,237
3780,12042.25,12049,7,11812,237
3781,12048.6,12052,3,11815,237
3782,12051.6,12055,3,11818,237
3783,12054.7,12058,3,11821,237
3784,12057.8,12061,3,11825,236
3785,12061.2,12065,4,11828,237
3786,12064.4,12068,4,11831,237
3787,12067.3,12071,4,11834,237
3788,12077.454545454546,12074,12797,11837,237
3789,12084.3,12077,12793,11840,237
3790,12087.2,12081,12794,11843,238
3791,12089.7,12084,12794,11846,238
3792,12092.5,12087,12794,11850,237
3793,12095.5,12090,12794,11853,237
3794,12098.3,12093,12795,11856,237
3795,12101.1,12096,12795,11859,237
3796,12104.2,12099,12795,11862,237
3797,12107.1,12102,12795,11865,237
3798,12110.0,12106,12796,11868,238
3799,12112.8,12109,12796,11871,238
3800,12116.4,12112,12796,11875,237
3801,12120.3,12115,12795,11878,237
3802,12123.7,12118,12794,11881,237
3803,12122.333333333334,12121,12799,11884,237
3804,12130.6,12124,12793,11887,237
3805,12134.9,12127,12792,11890,237
3806,12138.1,12130,12792,11893,237
3807,12140.6,12134,12793,11896,238
3808,12146.6,12137,12790,11900,237
3809,12152.5,12140,12788,11903,237
3810,12155.5,12143,12788,11906,237
3811,12157.9,12146,12788,11909,237
3812,12160.4,12150,12790,11912,238
3813,12162.7,12153,12790,11915,238
3814,12165.1,12156,12791,11918,238
3815,12167.2,12159,12792,11921,238
3816,12169.3,12162,12793,11925,237
3817,12171.3,12165,12794,11928,237
3818,12173.5,12168,12794,11931,237
3819,12175.6,12171,12795,11934,237
3820,12178.5,12175,12796,11937,238
3821,12181.2,12178,12797,11940,238
3822,12183.8,12181,12797,11943,238
3823,12186.5,12184,12798,11946,238
3824,12189.6,12187,12797,11950,237
3825,12192.7,12190,12797,11953,237
3826,12195.2,12194,12799,11956,238
3827,12197.4,12197,0,11959,238
3828,12210.8,12200,12789,11962,238
3829,12214.142857142857,12203,12789,11965,238
3830,12216.2,12206,12790,11968,238
3831,12218.5,12210,12792,11971,239
3832,12220.4,12213,12793,11975,238
3833,12222.5,12216,12794,11978,238
3834,12224.4,12219,12795,11981,238
3835,12226.5,12222,12796,11984,238
3836,12228.6,12225,12796,11987,238
3837,12230.9,12228,12797,11990,238
3838,12233.4,12232,12799,11993,239
3839,12235.3,12235,0,11996,239
3840,12237.6,12238,0,12000,238
3841,12237.583333333334,12241,3,12003,238
3842,12242.9,12244,1,12006,238
3843,12245.9,12247,1,12009,238
3844,12249.4,12250,1,12012,238
3845,12249.545454545454,12254,4,12015,239
3846,12250.75,12257,6,12018,239
3847,12259.2,12260,1,12021,239
3848,12261.2,12263,2,12025,238
3849,12268.416666666666,12266,12798,12028,238
3850,12271.7,12269,12797,12031,238
3851,12275.3,12272,12797,12034,238
3852,12277.5,12275,12798,12037,238
3853,12279.5,12279,0,12040,239
3854,12281.5,12282,0,12043,239
3855,12283.5,12285,2,12046,239
3856,12285.8,12288,2,12050,238
3857,12288.5,12291,2,12053,238
3858,12291.1,12294,3,12056,238
3859,12293.5,12297,4,12059,238
3860,12295.7,12300,4,12062,238
3861,12298.5,12303,4,12065,238
3862,12300.363636363636,12306,6,12068,238
3863,12304.6,12309,4,12071,238
3864,12307.7,12312,4,12075,237
3865,12311.4,12315,4,12078,237
3866,12315.2,12318,3,12081,237
3867,12317.9,12321,3,12084,237
3868,12320.0,12324,4,12087,237
3869,12322.0,12327,5,12090,237
3870,12335.066666666668,12330,12795,12093,237
3871,12337.363636363636,12333,12796,12096,237
3872,12342.0,12336,12794,12100,236
3873,12344.7,12339,12794,12103,236
3874,12347.3,12342,12795,12106,236
3875,12350.2,12345,12795,12109,236
3876,12352.5,12348,12796,12112,236
3877,12354.7,12351,12796,12115,236
3878,12357.9,12354,12796,12118,236
3879,12361.3,12356,12795,12121,235
3880,12364.2,12359,12795,12125,234
3881,12366.6,12362,12795,12128,234
3882,12369.2,12365,12796,12131,234
3883,12372.6,12368,12795,12134,234
3884,12376.2,12371,12795,12137,234
3885,12379.3,12374,12795,12140,234
3886,12382.9,12377,12794,12143,234
3887,12386.4,12380,12794,12146,234
3888,12390.4,12383,12793,12150,233
3889,12393.6,12386,12792,12153,233
3890,12395.8,12389,12793,12156,233
3891,12398.5,12392,12794,12159,233
3892,12404.2,12395,12791,12162,233
3893,12410.1,12398,12788,12165,233
3894,12412.8,12401,12788,12168,233
3895,12415.1,12404,12789,12171,233
3896,12417.3,12407,12790,12175,232
3897,12419.4,12410,12791,12178,232
3898,12421.4,12413,12792,12181,232
3899,12423.7,12416,12792,12184,232
3900,12425.7,12419,12793,12187,232
3901,12427.7,12422,12794,12190,232
3902,12429.8,12425,12795,12193,232
3903,12431.7,12428,12796,12196,232
3904,12434.1,12431,12797,12200,231
3905,12433.583333333334,12434,0,12203,231
3906,12439.4,12437,12798,12206,231
3907,12442.0,12440,12798,12209,231
3908,12444.9,12443,12798,12212,231
3909,12447.9,12446,12798,12215,231
3910,12450.4,12449,12799,12218,231
3911,12452.5,12452,0,12221,231
3912,12454.8,12455,0,12225,230
3913,12462.7,12458,12795,12228,230
3914,12470.5,12461,12790,12231,230
3915,12472.8,12464,12791,12234,230
3916,12475.0,12467,12792,12237,230
3917,12476.7,12470,12793,12240,230
3918,12478.7,12473,12794,12243,230
3919,12480.7,12476,12795,12246,230
3920,12482.8,12479,12796,12250,229
3921,12484.8,12482,12797,12253,229
3922,12486.8,12485,12798,12256,229
3923,12488.9,12488,12799,12259,229
3924,12491.1,12491,0,12262,229
3925,12492.9,12494,1,12265,229
3926,12495.7,12497,1,12268,229
3927,12498.5,12500,2,12271,229
3928,12501.2,12503,2,12275,228
3929,12502.09090909091,12506,4,12278,228
3930,12496.375,12509,13,12281,228
3931,12504.692307692309,12512,7,12284,228
3932,12514.2,12515,1,12287,228
3933,12516.2,12518,2,12290,228
3934,12518.6,12521,2,12293,228
3935,12524.2,12524,0,12296,228
3936,12529.6,12527,12797,12300,227
3937,12532.0,12529,12797,12303,226
3938,12534.0,12532,12798,12306,226
3939,12536.0,12535,12799,12309,226
3940,12538.2,12538,0,12312,226
3941,12537.666666666666,12541,3,12315,226
3942,12541.6,12544,2,12318,226
3943,12544.3,12547,3,12321,226
3944,12546.8,12550,3,12325,225
3945,12549.1,12553,4,12328,225
3946,12551.4,12556,5,12331,225
3947,12553.6,12559,5,12334,225
3948,12556.8,12561,4,12337,224
3949,12560.2,12564,4,12340,224
3950,12563.5,12567,4,12343,224
3951,12566.8,12570,3,12346,224
3952,12569.9,12573,3,12350,223
3953,12572.5,12576,4,12353,223
3954,12574.7,12579,4,12356,223
3955,12576.8,12581,4,12359,222
3956,12579.5,12584,4,12362,222
3957,12588.727272727272,12587,12798,12365,222
3958,12596.454545454546,12590,12794,12368,222
3959,12598.7,12593,12794,12371,222
3960,12601.3,12596,12795,12375,221
3961,12603.9,12598,12794,12378,220
3962,12606.4,12601,12795,12381,220
3963,12608.7,12604,12795,12384,220
3964,12611.1,12607,12796,12387,220
3965,12613.9,12610,12796,12390,220
3966,12616.7,12612,12795,12393,219
3967,12619.3,12615,12796,12396,219
3968,12621.7,12618,12796,12400,218
3969,12624.3,12621,12797,12403,218
3970,12628.3,12624,12796,12406,218
3971,12631.8,12627,12795,12409,218
3972,12634.5,12629,12794,12412,217
3973,12631.23076923077,12632,1,12415,217
3974,12642.2,12635,12793,12418,217
3975,12640.333333333334,12638,12798,12421,217
3976,12648.5,12640,12792,12425,215
3977,12650.8,12643,12792,12428,215
3978,12653.3,12646,12793,12431,215
3979,12663.533333333333,12649,12785,12434,215
3980,12662.7,12652,12789,12437,215
3981,12666.7,12654,12787,12440,214
3982,12669.3,12657,12788,12443,214
3983,12671.5,12660,12788,12446,214
3984,12673.9,12663,12789,12450,213
3985,12676.1,12665,12789,12453,212
3986,12677.9,12668,12790,12456,212
3987,12679.7,12671,12791,12459,212
3988,12681.6,12674,12792,12462,212
3989,12683.7,12677,12793,12465,212
3990,12685.6,12679,12793,12468,211
3991,12687.5,12682,12794,12471,211
3992,12689.9,12685,12795,12475,210
3993,12692.3,12688,12796,12478,210
3994,12694.7,12691,12796,12481,210
3995,12697.1,12694,12797,12484,210
3996,12700.2,12696,12796,12487,209
3997,12703.5,12699,12796,12490,209
3998,12706.1,12702,12796,12493,209
3999,12708.0,12705,12797,12496,209
4000,12709.8,12708,12798,12500,208
4001,12711.8,12710,12798,12503,207
4002,12718.7,12713,12794,12506,207
4003,12726.1,12716,12790,12509,207
4004,12729.1,12719,12790,12512,207
4005,12731.0,12722,12791,12515,207
4006,12733.0,12724,12791,12518,206
4007,12734.8,12727,12792,12521,206
4008,12736.7,12730,12793,12525,205
4009,12738.6,12733,12794,12528,205
4010,12740.4,12736,12796,12531,205
4011,12742.2,12739,12797,12534,205
4012,12744.3,12742,12798,12537,205
4013,12746.8,12744,12797,12540,204
4014,12748.8,12747,12798,12543,204
4015,12750.6,12750,12799,12546,204
4016,12750.818181818182,12753,2,12550,203
4017,12756.0,12756,0,12553,203
4018,12759.0,12759,0,12556,203
4019,12763.7,12761,12797,12559,202
4020,12767.9,12764,12796,12562,202
4021,12769.8,12767,12797,12565,202
4022,12771.8,12770,12798,12568,202
4023,12773.9,12773,12799,12571,202
4024,12780.083333333334,12775,12795,12575,200
4025,12778.625,12778,12799,12578,200
4026,12782.125,12781,12799,12581,200
4027,12784.25,12783,12799,12584,199
4028,12786.5,12786,0,12587,199
4029,12788.125,12789,1,12590,199
4030,12790.25,12792,2,12593,199
4031,12792.0,12795,3,12596,199
4032,12794.125,12796,2,12600,196
4033,12796.5,12799,2,12603,196
4034,12799.0,2,3,12606,196
4035,1.0,4,3,12609,195
4036,3.0,7,4,12612,195
4037,5.25,10,5,12615,195
4038,8.0,13,5,12618,195
4039,9.777777777777374,15,5,12621,194
4040,14.5,18,4,12625,193
4041,16.111111111111313,21,5,12628,193
4042,22.0,24,2,12631,193
4043,24.75,26,1,12634,192
4044,24.0,29,5,12637,192
4045,25.88888888888889,32,6,12640,192
4046,27.77777777777778,34,6,12643,191
4047,37.0,37,0,12646,191
4048,38.0,40,2,12650,190
4049,44.0,43,12799,12653,190
4050,46.22222222222222,45,12799,12656,189
4051,48.55555555555556,48,12799,12659,189
4052,51.0,51,0,12662,189
4053,53.22222222222222,54,1,12665,189
4054,56.0,56,0,12668,188
4055,58.77777777777778,59,0,12671,188
4056,61.666666666666664,62,0,12675,187
4057,64.44444444444444,65,1,12678,187
4058,66.66666666666667,67,0,12681,186
4059,69.22222222222223,70,1,12684,186
4060,71.44444444444444,73,2,12687,186
4061,75.33333333333333,76,1,12690,186
4062,78.77777777777777,79,0,12693,186
4063,81.11111111111111,81,0,12696,185
4064,77.61538461538461,84,6,12700,184
4065,83.5,87,4,12703,184
4066,95.0,89,12794,12706,183
4067,98.0,92,12794,12709,183
4068,100.22222222222223,95,12795,12712,183
4069,102.66666666666667,98,12795,12715,183
4070,107.44444444444444,100,12793,12718,182
4071,112.22222222222223,103,12791,12721,182
4072,114.77777777777777,106,12791,12725,181
4073,116.77777777777777,108,12791,12728,180
4074,118.88888888888889,111,12792,12731,180
4075,121.33333333333333,114,12793,12734,180
4076,123.88888888888889,117,12793,12737,180
4077,126.22222222222223,119,12793,12740,179
4078,127.88888888888889,122,12794,12743,179
4079,130.22222222222223,125,12795,12746,179
4080,131.88888888888889,128,12796,12750,178
4081,134.11111111111111,131,12797,12753,178
4082,136.22222222222223,133,12797,12756,177
4083,138.55555555555554,136,12797,12759,177
4084,140.55555555555554,139,12798,12762,177
4085,141.6,142,0,12765,177
4086,145.33333333333334,145,0,12768,177
4087,144.8181818181818,147,2,12771,176
4088,150.0,150,0,12775,175
4089,150.9090909090909,153,2,12778,175
4090,158.0,156,12798,12781,175
4091,159.88888888888889,159,12799,12784,175
4092,162.33333333333334,161,12799,12787,174
4093,168.11111111111111,164,12796,12790,174
4094,174.22222222222223,167,12793,12793,174
4095,None,170,0,12796,174
